ぁ	あ
ぃ	い
ぅ	う
ぇ	え
ぉ	お
っ	つ
ゃ	や
ゅ	ゆ
ょ	よ
いた	ゐた
うじゃ	うぢや
おり	をり
おる	をる
かえ	かへ
からじゃ	からぢや
かろう	からう
がえ	がへ
がなお	がなほ
きわ	きは
ぎわ	ぎは
ぐず	ぐづ
こう	かう
ごう	がう
さえ	さへ
さお	さを
さわ	さは
さわや	さわや
しず	しづ
しょう	せう
じゃ	ぢや
じゃけん	ぢやけん
じゃな	ぢやな
じゃよ	ぢやよ
すえ	すゑ
すじ	すぢ
すわ	すは
ずく	づく
ずつ	づつ
ずぶ	づぶ
そう	さう
そうらん節	そうらん節
ぞう	ざう
ぞえ	ぞへ
たえ	たへ
ちがい	ちがひ
ちがう	ちがふ
ちがえ	ちがへ
ちゃいつつ	ちやひつつ
ちゃいま	ちやひま
ちゃう	ちやふ
ちゃうま	ちやうま
ちゃうまえ	ちやふまへ
ちゃうまで	ちやふまで
ちゃうまま	ちやふまま
ちゃえ	ちやへ
ちゃおう	ちやはう
ちゃわ	ちやは
ちゃわん	ちやわん
てめえ	てめへ
でじゃ	でぢや
とかもうす	とかまうす
とじ	とぢ
ともうす	とまうす
どじ	どぢ
なえ	なへ
にじゃ	にじや
ぬい	ぬひ
ぬう	ぬふ
ぬえ	ぬへ
ぬおう	ぬはう
ぬわ	ぬは
ねじ	ねぢ
のじゃ	のぢや
ひじ	ひぢ
ひじり	ひじり
ほう	はう
ほうり	はふり
ほうる	はふる
ほうれ	はふれ
まえ	まへ
まず	まづ
みずほ	みづほ
もっか	もくか
もっか。	もつか。
ゆい	ゆひ
ゆう	いふ
よう	やう
ようか	ようか
ようが	ようが
ようじゃ	ようぢや
ようでは	ようでは
ようでは、	やうでは、
ようと	ようと
ようにも	ようにも
ようにも、	やうにも、
ようにも見える	やうにも見える
ようにも思える	やうにも思へる
ようにも受け取れる	やうにも受け取れる
ろう	らう
んじゃ	んぢや
アオ	アヲ
アジ	アヂ
イア	イヤ
ウィ	ウヰ
ウェ	ウヱ
ウォ	ウヲ
ウオ	ウヲ
ウオーラ	ウオーラ
ウジ	ウヂ
エイ	エヒ
オバ	ヲバ
キア	キヤ
ギア	ギヤ
クィ	クヰ
クエ	クヱ
クズ	クヅ
グィ	グヰ
シア	シヤ
ジア	ジヤ
スィ	スヰ
ズィ	ズヰ
ズキ	ヅキ
ズブ	ヅブ
ゾウ	ザウ
チア	チヤ
ヂア	ヂヤ
ッジ	ッヂ
ツィ	ツヰ
ツェ	ツヱ
ヅィ	ヅヰ
ティーク	チック
ティシズム	チシズム
ティス	チス
ティズム	チズム
ティック	チック
ティブ	チブ
ティン	チン
ティング	チング
ティヴ	チヴ
ディング	ヂング
ドジ	ドヂ
ニア	ニヤ
ニウム	ニューム
ヌィ	ヌヰ
ネジ	ネヂ
ハエ	ハヘ
ハズ	ハヅ
ヒア	ヒヤ
ヒジ	ヒヂ
ビア	ビヤ
ピア	ピヤ
フィ	フヰ
フィア	フヰヤ
フィロソ	フヰロソ
フェア	フヱヤ
ブィ	ブヰ
ブィア	ブヰヤ
プィ	プヰ
ミア	ミヤ
ムィ	ムヰ
リア	リヤ
リッジ	リッヂ
ルィ	ルヰ
ヴィ	ヴヰ
ヴェ	ヴヱ
ージュ	ーヂュ
Ｔ字	丁字
あいあいがさ	あひあひがさ
あいあい傘	あひあひ傘
あいいれ	あひいれ
あいいろ	あゐいろ
あいおい	あひおひ
あいかた	あひかた
あいくち	あひくち
あいだ	あひだ
あいついだ	あひついだ
あいついで	あひついで
あいつぎ	あひつぎ
あいつぎら	あひつぎら
あいつぐ	あひつぐ
あいつぐち	あいつぐち
あいつげば	あひつげば
あいつごう	あひつがう
あいづち	あひづち
あいのこ	あひのこ
あいのて	あひのて
あいのり	あひのり
あいの子	あひの子
あいの手	あひの手
あいびき	あひびき
あいまあいま	あひまあひま
あいまい	あいまい
あいまが	あひまが
あいまで	あひまで
あいまに	あひまに
あいまの	あひまの
あいまを	あひまを
あい済みま	あひ濟みま
あい次	あひ次
あい乗り	あひ乘り
あい色	あゐ色
あい成	あひ成
あい変わら	あひ變はら
あう	あふ
あうん	あうん
あえ	あへ
あえかな	あえかな
あえかに	あえかに
あおあおと	あをあをと
あおい	あをい
あおいだ	あふいだ
あおいで	あふいで
あおかっ	あをかつ
あおからざ	あをからざ
あおからず	あをからず
あおからぬ	あをからぬ
あおかり	あをかり
あおかろう	あをからう
あおがえる	あをがへる
あおがざ	あふがざ
あおがず	あふがず
あおがなかっ	あふがなかつ
あおがなかり	あふがなかり
あおがなかろう	あふがなからう
あおがなく	あふがなく
あおがぬ	あふがぬ
あおぎ	あふぎ
あおく	あをく
あおぐ	あふぐ
あおければ	あをければ
あおげ	あふげ
あおごう	あふがう
あおざめ	あをざめ
あおぞら	あをぞら
あおだいしょう	あをだいしやう
あおった	あふつた
あおって	あふつて
あおのけ	あふのけ
あおのり	あをのり
あおば	あをば
あおばえ	あをばへ
あおみず	あをみづ
あおむか	あふむか
あおむき	あふむき
あおむく	あふむく
あおむけ	あふむけ
あおむし	あをむし
あおやぎ	あをやぎ
あおら	あふら
あおり	あふり
あおる	あふる
あおれ	あふれ
あおれから	あおれから
あおれが	あおれが
あおれさま	あおれさま
あおれしか	あおれしか
あおれで	あおれで
あおれの	あおれの
あおれは	あおれは
あおれも	あおれも
あおれ様	あおれ様
あおろう	あふらう
あお海苔	あを海苔
あからがお	あからがほ
あかんぼう	あかんばう
あがない	あがなひ
あがなう	あがなふ
あがなえ	あがなへ
あがなおう	あがなはう
あがなわ	あがなは
あくたろう	あくたらう
あげしお	あげしほ
あげつらい	あげつらひ
あげつらう	あげつらふ
あげつらえ	あげつらへ
あげつらおう	あげつらはう
あげつらわ	あげつらは
あげはちょう	あげはてふ
あこうだい	あかをだひ
あこう鯛	あかを鯛
あさがお	あさがほ
あざない	あざなひ
あざなう	あざなふ
あざなえ	あざなへ
あざなおう	あざなはう
あざなわ	あざなは
あしなえ	あしなへ
あしらい	あしらひ
あしらう	あしらふ
あしらえ	あしらへ
あしらおう	あしらはう
あしらわ	あしらは
あじ	あぢ
あじあわ	あぢはは
あじけな	あぢけな
あじけの	あじけの
あじさい	あぢさゐ
あじわい	あぢはひ
あじわう	あぢはふ
あじわえ	あぢはへ
あじわおう	あぢははう
あじわっ	あじはつ
あじわわ	あぢはは
あずか	あづか
あずき	あづき
あずけ	あづけ
あずさ	あづさ
あずま	あづま
あせみず	あせみづ
あそぼう	あそばう
あたいし	あたひし
あたいす	あたひす
あたいせ	あたひせ
あたえ	あたへ
あたりさわり	あたりさはり
あたりまえ	あたりまへ
あたわ	あたは
あつかい	あつかひ
あつかう	あつかふ
あつかえ	あつかへ
あつかおう	あつかはう
あつかわ	あつかは
あつらえ	あつらへ
あてがい	あてがひ
あてがう	あてがふ
あてがえ	あてがへ
あてがおう	あてがはう
あてがわ	あてがは
あてずっぽう	あてずつぱう
あとあじ	あとあぢ
あとまわし	あとまはし
あびせたお	あびせたふ
あほうどり	あはうどり
あほう鳥	あはう鳥
あまえんぼう	あまえんばう
あまがえる	あまがへる
あまつさえ	あまつさへ
あまのがわ	あまのがは
あめもよう	あめもやう
あめんぼう	あめんばう
あもう	あまう
あやうい	あやふい
あやうう	あやふう
あやうか	あやふか
あやうく	あやふく
あやうけれ	あやふけれ
あゆもう	あゆまう
あらいが	あらひが
あらいぐま	あらひぐま
あらいし	あらひし
あらいする	あらひする
あらいすれ	あらひすれ
あらいせ	あらひせ
あらいだ	あらひだ
あらいつつ	あらひつつ
あらいつづ	あらひつづ
あらいで	あらひで
あらいな	あらひな
あらいながら	あらひながら
あらいに	あらひに
あらいは	あらひは
あらいまく	あらひまく
あらいまし	あらひまし
あらいましが	あらいましが
あらいます	あらひます
あらいませ	あらひませ
あらいも	あらひも
あらいを	あらひを
あらい続	あらひ續
あらう	あらふ
あらえ	あらへ
あらおう	あらはう
あらがい	あらがひ
あらがう	あらがふ
あらがえ	あらがへ
あらがおう	あらがはう
あらがわ	あらがは
あらけずりだ	あらけづりだ
あらけずりで	あらけづりで
あらけずりな	あらけづりな
あらけずりに	あらけづりに
あらけずりね	あらけづりね
あらけずりの	あらけづりの
あらけずりよ	あらけづりよ
あらそい	あらそひ
あらそう	あらそふ
あらそう？	あらさう？
あらそうだ	あらさうだ
あらそうだろう	あらそふだらう
あらそうでし	あらさうでし
あらそうです	あらさうです
あらそうなの	あらさうなの
あらそうなんだ	あらさうなんだ
あらそうなんで	あらさうなんで
あらそえ	あらそへ
あらそおう	あらそはう
あらそわ	あらそは
あらりょうじ	あられうぢ
あらわさ	あらはさ
あらわさび	あらわさび
あらわし	あらはし
あらわしが	あらわしが
あらわしだ	あらわしだ
あらわしで	あらわしで
あらわしの	あらわしの
あらわしも	あらわしも
あらわす	あらはす
あらわすれ	あらわすれ
あらわず	あらはず
あらわせ	あらはせ
あらわそう	あらはさう
あらわだ	あらはだ
あらわで	あらはで
あらわな	あらはな
あらわに	あらはに
あらわにが	あらわにが
あらわる	あらはる
あらわれ	あらはれ
ありあわせ	ありあはせ
ありがとう	ありがたう
ありよう	ありやう
あれもよう	あれもやう
あろう	あらう
あわ	あは
あわただ	あわただ
あわだ	あわだ
あわて	あわて
あわで	あわで
あわとな	あわとな
あわと消	あわと消
あわにな	あわにな
あわび	あはび
あわふき	あわふき
あわぶき	あわぶき
あわもり	あわもり
あわゆき	あわゆき
あわを食	あわを食
あわを吹	あわを吹
あわガラス	あわガラス
あわ吹き	あわ吹き
あわ立	あわ立
あんがい	あんぐわい
あんこう	あんかう
あんじょう	あんぢよう
あんじよう	あんぢよう
あんのじょう	あんのぢよう
いあわせ	ゐあはせ
いい臭い	いい臭ひ
いえざり	いへざり
いえざる	いへざる
いえざれ	いへざれ
いえざろう	いへざらう
いえず	いへず
いえた	いへた
いえて	いへて
いえない	いへない
いえなかっ	いへなかつ
いえなかり	いへなかり
いえなかろう	いへなからう
いえなく	いへなく
いえなけれ	いへなけれ
いえぬ	いへぬ
いえば	いへば
いえました	いへました
いえまして	いへまして
いえましょう	いへませう
いえます	いへます
いえませ	いへませ
いえよう	いへよう
いえる	いへる
いえれば	いへれば
いおう病	ゐわう病
いかがわしい	いかがはしい
いかがわしか	いかがはしか
いかがわしき	いかがはしき
いかがわしく	いかがはしく
いかがわしけれ	いかがはしけれ
いかがわしゅう	いかがはしう
いかずち	いかづち
いかようだ	いかやうだ
いかようで	いかやうで
いかような	いかやうな
いかように	いかやうに
いかようの	いかやうの
いがらっぽ	ゑがらつぽ
いきおい	いきほひ
いきおう	いきほふ
いきおえ	いきほへ
いきだおれ	いきだふれ
いきちがい	いきちがひ
いきどお	いきどほ
いくじがな	いくぢがな
いくじが無	いくぢが無
いくじない	いくぢない
いくじなき	いくぢなき
いくじなし	いくぢなし
いくじのな	いくぢのな
いくじの無	いくぢの無
いくじもな	いくぢもな
いくじも無	いくぢも無
いけにえ	いけにへ
いさかい	いさかひ
いざない	いざなひ
いざなう	いざなふ
いざなえ	いざなへ
いざなおう	いざなはう
いざなわ	いざなは
いざよい	いざよひ
いざよう	いざよふ
いざよえ	いざよへ
いざよおう	いざよはう
いざよわ	いざよは
いしずえ	いしずゑ
いじくっ	いぢくつ
いじくら	いぢくら
いじくり	いぢくり
いじくる	いぢくる
いじくれ	いぢくれ
いじくろう	いぢくらう
いじけ	いぢけ
いじっ	いぢつ
いじめ	いぢめ
いじら	いぢら
いじらし	いじらし
いじらしい	いぢらしい
いじらしか	いぢらしか
いじらしき	いぢらしき
いじらしく	いぢらしく
いじらしけれ	いぢらしけれ
いじらしゅう	いぢらしう
いじり	いぢり
いじる	いぢる
いじれ	いぢれ
いじろう	いぢらう
いすわっ	ゐすわつ
いすわらざ	ゐすわらざ
いすわらず	ゐすわらず
いすわらな	ゐすわらな
いすわらぬ	ゐすわらぬ
いすわられ	ゐすわられ
いすわり	ゐすわり
いすわる	ゐすわる
いすわれ	ゐすわれ
いすわろう	ゐすわらう
いずくんか	いづくんか
いずくんぞ	いづくんぞ
いずこ	いづこ
いずここ	いずここ
いずこちら	いずこちら
いずこの	いずこの
いずこれ	いずこれ
いずこんな	いずこんな
いずみ	いづみ
いずもそば	いづもそば
いずもの	いづもの
いずれ	いづれ
いそうろう	ゐさふらふ
いそしもう	いそしまう
いたいけ	いたいけ
いたいまつ	いたいまつ
いたおやか	いたをやか
いたがっ	いたがつ
いたがら	いたがら
いたがり	いたがり
いたがる	いたがる
いたがれば	いたがれば
いたがろう	いたがらう
いたくあん	いたくあん
いたくまし	いたくまし
いたくらみ	いたくらみ
いたくわえ	いたくわへ
いたくわん	いたくわん
いたく感	いたく感
いたく心	いたく心
いたこが	いたこが
いたこさえ	いたこさへ
いたこしか	いたこしか
いたこだ	いたこだ
いたこで	いたこで
いたこな	いたこな
いたこに	いたこに
いたこのみ	いたこのみ
いたこは	いたこは
いたこまで	いたこまで
いたこも	いたこも
いたこを	いたこを
いたこ焼	いたこ焼
いたさざら	いたさざら
いたさざり	いたさざり
いたさざる	いたさざる
いたさざれ	いたさざれ
いたさず	いたさず
いたさずかり	ゐたさずかり
いたさずかりに	いたさずかりに
いたさな	いたさな
いたさなぎ	ゐたさなぎ
いたさに	いたさに
いたさぬ	いたさぬ
いたさぬき	ゐたさぬき
いたした	いたした
いたしつつ	いたしつつ
いたしつづ	いたしづつ
いたして	いたして
いたしながら	いたしながら
いたしなみ	いたしなみ
いたしまく	いたしまく
いたしまし	いたしまし
いたしましま	いたしましま
いたします	いたします
いたしませ	いたしませ
いたしやし	いたしやし
いたす。	いたす。
いたすこと	いたすこと
いたすところ	いたすところ
いたすもの	いたすもの
いたす考	いたす考
いたす者	いたす者
いたす所	いたす處
いたす物	いたす物
いたずら	いたづら
いたせ、	いたせ、
いたせ。	いたせ。
いたせば	いたせば
いたそう、	いたさう、
いたそう。	いたさう。
いたそうと	いたさうと
いたたずまい	いたたづまい
いたたみ	いたたみ
いただいた	いただいた
いただいて	いただいて
いただか	いただか
いただかれたい男	ゐただかれたい男
いただき	いただき
いただきますよう	いただきますやう
いただく	いただく
いただけず	いただけず
いただけた	いただけた
いただけたのし	ゐただけたのし
いただけたまら	ゐただけたまら
いただけて	いただけて
いただけない	いただけない
いただけなか	いただけなか
いただけなく	いただけなく
いただけなけれ	いただけなけれ
いただけぬ	いただけん
いただけのう	いただけなう
いただけま	いただけま
いただけまし、	ゐただけまし、
いただけまし。	ゐただけまし。
いただけましだ	ゐただけましだ
いただけましで	ゐただけましで
いただけましと	ゐただけましと
いただけましな	ゐただけましな
いただけましに	ゐただけましに
いただけますよう	いただけますやう
いただける	いただける
いただけれ	いただけれ
いただこう	いただかう
いただなら	いただなら
いたち	いたち
いたちいさ	ゐたちいさ
いたちえ	ゐたちえ
いたちから	ゐたちから
いたちかん	ゐたちかん
いたちがい	ゐたちがひ
いたちがいた	いたちがゐた
いたちがいて	いたちがゐて
いたちがいな	いたちがゐな
いたちがいる	いたちがゐる
いたちがう	ゐたちがふ
いたちがうしろ	いたちがうしろ
いたちがうめ	いたちがうめ
いたちがうんと	いたちがうんと
いたちがっ	ゐたちがつ
いたちきしょう	ゐたちくしやう
いたちくしょう	ゐたちくしやう
いたちばな	いたちばな
いたちまち	いたちまち
いたちょっと	ゐたちよつと
いたちり	ゐたちり
いたちん	ゐたちん
いたちんぼう	いたちんばう
いたちん坊	いたちん坊
いたった	いたつた
いたっち	いたつち
いたって	いたつて
いたってしかたがない	ゐたつてしかたがない
いたってしかたない	ゐたつてしかたない
いたってしょうがない	ゐたつてしやうがない
いたって仕方がない	ゐたつて仕方がない
いたって仕方ない	ゐたつて仕方ない
いたっと	いたつと
いたっとさけ	いたつとさけ
いたっと叫	いたつと叫
いたっぷり	いたつぷり
いたつまき	いたつまき
いたなぼた	いたなぼた
いたなボタ	いたなボタ
いたぬき	いたぬき
いたのし	いたのし
いたのしい	いたのしい
いたばこ	いたばこ
いたましい	いたましひ
いたまな	いたまな
いたまねぎ	いたまねぎ
いたまもの	いたまもの
いたまわざ	ゐたまはざ
いたまわず	ゐたまはず
いたまわぬ	ゐたまはぬ
いたまわね	ゐたまはね
いたみ	いたみ
いたみなさん	ゐたみなさん
いたみなの	ゐたみなの
いたみなのか	いたみなのか
いたみなのさ	いたみなのさ
いたみなのだ	いたみなのだ
いたみなので	いたみなので
いたみなのね	いたみなのね
いたみなのも	いたみなのも
いたみなのよ	いたみなのよ
いたみま	いたみま
いたみんな	ゐたみんな
いたむ	いたむ
いたむかいの	ゐたむかひの
いたむき	ゐたむき
いたむぎ	ゐたむぎ
いたむく	ゐたむく
いたむこが	ゐたむこが
いたむこさん	ゐたむこさん
いたむこは	ゐたむこは
いたむこも	ゐたむこも
いたむごい	ゐたむごい
いたむごくて	ゐたむごくて
いたむさくるし	ゐたむさくるし
いたむささび	ゐたむささび
いたむさ苦	ゐたむさ苦
いたむすこ	ゐたむすこ
いたむすめ	ゐたむすめ
いたむずか	ゐたむづか
いたむせ	ゐたむせ
いたむだが	ゐたむだが
いたむだだ	ゐたむだだ
いたむだで	ゐたむだで
いたむだな	ゐたむだな
いたむだに	ゐたむだに
いたむだの	ゐたむだの
いたむだは	ゐたむだは
いたむだも	ゐたむだも
いたむちむち	ゐたむちむち
いたむっちり	ゐたむつちり
いたむなし	ゐたむなし
いたむねお	ゐたむねお
いたむねお伝え	ゐたむねお傳へ
いたむねが	ゐたむねが
いたむねは	ゐたむねは
いたむねを	ゐたむねを
いたむねメール	ゐたむねメイル
いたむね書	ゐたむね書
いたむね承	ゐたむね承
いたむね申	ゐたむね申
いたむね伝	ゐたむね傳
いたむね伝え	ゐたむね傳へ
いたむね電	ゐたむね電
いたむね聞	ゐたむね聞
いたむね連絡	ゐたむね聯絡
いたむふふ	ゐたむふふ
いたむやみ	ゐたむやみ
いたむらかみ	ゐたむらかみ
いたむらから	ゐたむらから
いたむらが	ゐたむらが
いたむらさえ	ゐたむらさへ
いたむらさき	ゐたむらさき
いたむらだ	ゐたむらだ
いたむらで	ゐたむらで
いたむらな	ゐたむらな
いたむらに	ゐたむらに
いたむらの	ゐたむらの
いたむらも	ゐたむらも
いため	いため
いためた	いためた
いためだ	いためだ
いためて	いためて
いためで	いためで
いためでた	ゐためでた
いためな	いためな
いために	いために
いためね	いためね
いための	いための
いためま	いためま
いためよ	いためよ
いため息	いため息
いたよう	ゐたやう
いたらい	いたらひ
いたらこ	いたらこ
いたらざ	いたらざ
いたらず	いたらず
いたらずいぶん	ゐたらずいぶん
いたらずっと	ゐたらずっと
いたらない	いたらない
いたらなか	いたらなか
いたらなく	いたらなく
いたらなけれ	いたらなけれ
いたらぬ	いたらぬ
いたらのう	いたらなう
いたらのうみそ	ゐたらのうみそ
いたらばがに	いたらばがに
いたらば蟹	いたらば蟹
いたらふく	いたらふく
いたらん	いたらん
いたらんらんと	ゐたらんらんと
いたりま	いたりま
いたる	いたる
いたれり	いたれり
いたろう	いたらう
いたろうそく	いたらふそく
いたろう細工	いたらふ細工
いたろう人形	いたらふ人形
いたろう染	いたらふ染
いたわけもの	いたはけもの
いたわけ者	いたはけ者
いたわごと	いたはごと
いたわしい	いたはしい
いたわしう	いたはしう
いたわしかっ	いたはしかつ
いたわしかり	いたはしかり
いたわしかろ	いたはしから
いたわしき	いたはしき
いたわしく	いたはしく
いたわしけれ	いたはしけれ
いたわしゅう	いたはしう
いたわっ	いたはつ
いたわら	いたはら
いたわり	いたはり
いたわりに	ゐたわりに
いたわる	いたはる
いたわれ	いたはれ
いたわろう	いたはらう
いたわ言	いたは言
いたんこぶ	いたんこぶ
いたんす	いたんす
いたんす、	ゐたんす、
いたんす。	ゐたんす。
いたんすか	ゐたんすか
いたんすけ	ゐたんすけ
いたんすね	ゐたんすね
いたんすよ	ゐたんすよ
いたんぱく	いたんぱく
いたんめん	いたんめん
いたん塩	いたん鹽
いたん麺	いたん麺
いたん瘤	いたん瘤
いちゃついた	いちやついた
いちゃついて	いちやついて
いっこうに	いつかうに
いっぽう	いつぱう
いつわっ	いつはつ
いつわら	いつはら
いつわり	いつはり
いつわる	いつはる
いつわれ	いつはれ
いつわろう	いつはろう
いて	ゐて
いてぇ	いてぇ
いてっ	いてっ
いてついた	いてついた
いてついて	いてついて
いてつく	いてつく
いてつくし	ゐてつくし
いてつくす	ゐてつくす
いてつくずく	ゐてつくづく
いてつくせ	ゐてつくせ
いてつくっ	ゐてつくつ
いてつくづく	ゐてつくづく
いてつくね	ゐてつくね
いてつくら	ゐてつくら
いてつくり	ゐてつくり
いてつくる	ゐてつくる
いてつくれ	ゐてつくれ
いてつくろう	ゐてつくらう
いて座	いて座
いとうこと	いとふこと
いとうじゃ	いとふぢや
いとうだけ	いとふだけ
いとうでも	いとふでも
いとうとし	いとふとし
いとうとす	いとふとす
いとうなら	いとふなら
いとうのが	いとふのが
いとうのは	いとふのは
いとうもの	いとふもの
いとう者	いとふ者
いとえば	いとへば
いとおし	いとほし
いとわざ	いとはざ
いとわざら	いとはざら
いとわざり	いとはざり
いとわざる	いとはざる
いとわざれ	いとはざれ
いとわざろう	いとはざらう
いとわしい	いとはしい
いとわしか	いとはしか
いとわしき	いとはしき
いとわしく	いとはしく
いとわしけれ	いとはしけれ
いとわしゅう	いとはしう
いとわず	いとはず
いとわない	いとはない
いとわなか	いとはなか
いとわなく	いとはなく
いとわなけれ	いとはなけれ
いとわぬ	いとはぬ
いとわん	いとはん
いどころ	ゐどころ
いない	ゐない
いなおっ	ゐなほつ
いなおら	ゐなほら
いなおり	ゐなほり
いなおる	ゐなほる
いなおれば	ゐなほれば
いなおろう	ゐなほらう
いなかざむらい	ゐなかざむらひ
いなかじみ	ゐなかじみ
いなかそば	ゐなかそば
いなかっ	ゐなかつ
いなかっぺ	ゐなかつぺ
いなかみそ	ゐなかみそ
いなかもの	ゐなかもの
いなかろう	ゐなからう
いなか蕎麦	ゐなか蕎麦
いなか侍	ゐなか侍
いなか味噌	ゐなか味噌
いながらに	ゐながらに
いなくて	ゐなくて
いなければ	ゐなければ
いなずま	いなづま
いなない	いなない
いならぶ	ゐならぶ
いにしえ	いにしへ
いぬい	いぬゐ
いねむり	ゐねむり
いのしし	ゐのしし
いばった	ゐばつた
いばっち	ゐばつち
いばって	ゐばつて
いばっと	ゐばつと
いばらざ	ゐばらざ
いばらず	ゐばらず
いばらな	ゐばらな
いばらぬ	ゐばらぬ
いばられ	ゐばられ
いばりじゃ	ゐばりぢや
いばりだ	ゐばりだ
いばりで	ゐばりで
いばりに	ゐばりに
いばりね	ゐばりね
いばりの	ゐばりの
いばりま	ゐばりま
いばりよ	ゐばりよ
いばる	ゐばる
いばれば	ゐばれば
いばれる	ゐばれる
いばろう	ゐばらう
いぶくろ	ゐぶくろ
いぼがえる	いぼがへる
いまがわやき	いまがはやき
いましがた	いましがた
いました	ゐました
いまして	ゐまして
いましょう	ゐませう
います	ゐます
いますいか	いますいか
いますえ	いますゑ
いますえ。	ゐますえ。
いますかさず	いますかさず
いますかっと	いますかつと
いますかんぴん	いますかんぴん
いますがお	いますがお
いますがすが	いますがすが
いますがた	いますがた
いますがって	いますがつ
いますがめ	いますがめ
いますがら	いますがら
いますがり	いますがり
いますがる	いますがる
いますがれば	いますがれば
いますがろう	いますがらう
いますきか	いますきか
いますききら	いますききら
いますきこの	いますきこの
いますきずき	いますきずき
いますきだ	いますきだ
いますきっぱら	いますきつぱら
いますきで	いますきで
いますきと	いますきと
いますきな	いますきな
いますきに	いますきに
いますぎ	いますぎ
いますぎた	いますぎた
いますぎて	いますぎて
いますくい	いますくひ
いますくう	いますくふ
いますくえ	いますくへ
いますくこう	いますくはう
いますくすく	いますくすく
いますくっ	いますくつ
いますくっと	いますくつと
いますくな	いますくな
いますくみ	いますくみ
いますくむ	いますくむ
いますくわ	いますくは
いますぐ	いますぐ
いますぐれ	いますぐれ
いますけこま	いますけこま
いますけべ	いますけべ
いますけろく	いますけろく
いますげかえ	いますげかへ
いますげな	いますげな
いますこし	いますこし
いますこぶる	いますこぶる
いますこやか	いますこやか
いますごい	いますごい
いますごか	いますごか
いますごく	いますごく
いますごけれ	いますごけれ
いますごさ	いますごさ
いますごし	いますごし
いますごす	いますごす
いますごすご	いますごすご
いますごせ	いますごせ
いますごそう	いますごさう
いますごま	いますごま
いますごみ	いますごみ
いますごむ	いますごむ
いますごめ	いますごめ
いますごもう	いますごまう
いますごろく	いますごろく
いますごん	いますごん
いますさまじ	いますさまじ
いますすき	いますすき
いますすぎ	いますすぎ
いますすけ	いますすけ
いますすだらけ	いますすだらけ
いますすっ	いますすつ
いますすはらい	いますすはらひ
いますすま	いますすま
いますすみ	いますすみ
いますすむ	いますすむ
いますすめ	いますすめ
いますすもう	いますすまう
いますすら	いますすら
いますすり	いますすり
いますする	いますする
いますすれ	いますすれ
いますすろう	いますすらう
いますすん	いますすん
いますずし	いますずし
いますずめ	いますずめ
いますずらん	いますずらん
いますずり	いますずり
いますそが	いますそが
いますそを	いますそを
いますたこら	いますたこら
いますたすた	いますたすた
いますたっ	いますたつ
いますたら	いますたら
いますたり	いますたり
いますたる	いますたる
いますたれ	いますたれ
いますたろう	いますたらう
いますだち	いますだち
いますちゃらか	いますちゃらか
いますっ、	いますっ、
いますっ。	いますっ。
いますっ」	いますっ」
いますて	いますて
いますとん	いますとん
いますなかぶり	いますなかぶり
いますなぎも	いますなぎも
いますなけむり	いますなけむり
いますなわち	いますなはち
いますなを	いますなを
いますねかじり	いますねかじり
いますねが	いますねが
いますねた	いますねた
いますねたが	ゐますねたが
いますねただ	ゐますねただ
いますねたで	ゐますねたで
いますねたな	ゐますねたな
いますねたに	ゐますねたに
いますねたの	ゐますねたの
いますねたも	ゐますねたも
いますねたを	ゐますねたを
いますねて	いますねて
いますねに	いますねに
いますねる	いますねる
いますねを	いますねを
いますば	いますば
いますばしこ	いますばしこ
いますぱ	いますぱ
いますべからく	いますべからく
いますべが	いますべが
いますべすべ	いますべすべ
いますべっ	いますべつ
いますべて	いますべて
いますべら	いますべら
いますべり	いますべり
いますべる	いますべる
いますべれ	いますべれ
いますべろう	いますべらう
いますべを	いますべを
いますぼま	いますぼま
いますぼみ	いますぼみ
いますぼむ	いますぼむ
いますぼめ	いますぼめ
いますぼもう	いますぼまう
いますぼん	いますぼん
いますぽ	いますぽ
いますまし	いますまし
いますみか	いますみか
いますみこみ	いますみこみ
いますみずみ	いますみずみ
いますみなれ	いますみなれ
いますみませ	いますみませ
いますみやか	いますみやか
いますみれ	いますみれ
いますみわた	いますみわた
いますむこと	いますむこと
いますむとき	いますむとき
いますむの	いますむの
いますむもの	いますむもの
いますむ家	いますむ家
いますむ街	いますむ街
いますむ国	いますむ國
いますむ住	いますむ住
いますむ人	いますむ人
いますむ村	いますむ村
いますむ町	いますむ町
いますむ部屋	いますむ部屋
いますめら	いますめら
いますもう	いますまふ
いますやすや	いますやすや
いますら	いますら
いますりおろ	いますりおろ
いますりきれ	いますりきれ
いますりこ	いますりこ
いますりつぶ	いますりつぶ
いますりぬけ	いますりぬけ
いますりへ	いますりへ
いますりむ	いますりへむ
いますりゃ	いますりや
いますりよ	いますりよ
いますりガラス	いますりガラス
いまする	いまする
いますれあう	いますれあふ
いますれた	いますれた
いますれちがい	いますれちがひ
いますれちがう	いますれちがふ
いますれちがえ	いますれちがへ
いますれちがおう	いますれちがはう
いますれちがっ	いますれちがつ
いますれて	いますれて
いますれば	いますれば
いますろう	いますらう
いますわっ	いますわつ
いますわら	いますわら
いますわり	いますわり
いますわる	いますわる
いますわれ	いますわれ
いますわろう	いますわらう
いますんでの	いますんでの
いますんなり	いますんなり
いませ	ゐませ
いませた	いませた
いませて	いませて
いまなお	いまなほ
いまわしい	いまはしい
いまわしか	いまはしか
いまわしき	いまはしき
いまわしく	いまはしく
いまわしけれ	いまはしけれ
いまわしゅう	いまはしう
いまわのきわ	いまはのきは
いもり	ゐもり
いもりそば	いもりそば
いもりもり	いもりもり
いもりソバ	いもりソバ
いもり蕎麦	いもり蕎麦
いやな臭い	いやな臭ひ
いられ	ゐられ
いる	ゐる
いれば	ゐれば
いろり	ゐろり
いわいが	いはひが
いわいし	いはひし
いわいする	いはひする
いわいすれ	いはひすれ
いわいせ	いはひせ
いわいせつ	いわいせつ
いわいだ	いはひだ
いわいつつ	いはひつつ
いわいつづ	いはひつづ
いわいで	いはひで
いわいな	いはひな
いわいに	いはひに
いわいの	いはひの
いわいは	いはひは
いわいま	いはひま
いわいも	いはひも
いわいを	いはひを
いわう	いはふ
いわえば	いはへば
いわお	いはほ
いわく	いはく
いわくわく	いわくわく
いわさざ	いはさざ
いわさず	いはさず
いわさぬ	いはさぬ
いわさん	いはさん
いわざる	いはざる
いわざれ	いはざれ
いわしみず	いはしみづ
いわず	いはず
いわずかだ	いわづかだ
いわずかで	いわづかで
いわずかな	いわづかな
いわずかに	いわづかに
いわずかの	いわづかの
いわずらい	いわづらひ
いわずらわ	いわずらは
いわせ	いはせ
いわない	いはない
いわぬ	いはぬ
いわね	いはね
いわば	いはば
いわゆる	いはゆる
いわれ	いはれ
いわれら	いわれら
いわれわれ	いわれわれ
いわわざ	いははざ
いわわず	いははず
いわわな	いははな
いわわぬ	いははぬ
いわわのう	いははなう
いわわん	いははん
いわん	いはん
いわんこ	いわんこ
いわんぱく	いわんぱく
いわんわん	いわんわん
いんねんを	いんえんを
ういうい	うひうひ
ういざん	うひざん
ういろう	ういらう
うえから	うへから
うえざらん	うゑざらむ
うえざり	うゑざり
うえざる	うゑざる
うえざれ	うゑざれ
うえずして	うゑずして
うえずじま	うゑずじま
うえずに	うゑずに
うえつけ	うゑつけ
うえつつ	うゑつつ
うえつづ	うゑつづ
うえない	うゑない
うえなか	うゑなか
うえなかなか	うへなかなか
うえながら	うゑながら
うえなく	うゑなく
うえなけれ	うゑなけれ
うえに	うへに
うえぬ	うゑぬ
うえまくっ	うゑまくつ
うえまくり	うゑまくり
うえまくる	うゑまくる
うえまくれ	うゑまくれ
うえます	うゑます
うえよ	うゑよ
うえようと	うゑようと
うえる	うゑる
うえれば	うゑれば
うえろ	うゑろ
うえ続	うえ續
うおーさおー	うわうさわう
うおうさおう	うわうさわう
うおごころ	うをごころ
うおのめ	うをのめ
うかがい	うかがひ
うかがう	うかがふ
うかがえ	うかがへ
うかがおう	うかがはう
うかがわ	うかがは
うかつじゃ	うくわつぢや
うかつだ	うくわつだ
うかつで	うくわつで
うかつな	うくわつな
うかつに	うくわつに
うかつね	うくわつね
うかつよ	うくわつよ
うがい	うがひ
うがとうが	うがたうが
うがとうじゃ	うがたうぢや
うがとうで	うがたうで
うがとうと	うがたうと
うがとうに	うがたうに
うぐいす	うぐひす
うけおい	うけおひ
うけおう	うけおふ
うけおえ	うけおへ
うけおおう	うけおはう
うけおわ	うけおは
うけがい	うけがひ
うけがう	うけがふ
うけがえ	うけがひ
うけがおう	うけがはう
うけがわ	うけがは
うごめいた	うごめいた
うごめいて	うごめいて
うしお	うしほ
うしがえる	うしがへる
うしない	うしなひ
うしなう	うしなふ
うしなえ	うしなへ
うしなおう	うしなはう
うしなわ	うしなは
うじうじ	うぢうぢ
うすじお	うすじほ
うずいた	うづいた
うずいて	うづいて
うずかざ	うづかざ
うずかず	うづかず
うずかな	うづかな
うずかぬ	うづかぬ
うずかん	うづかん
うずが	うづが
うずき	うづき
うずく	うづく
うずけば	うづけば
うずこう	うづかう
うずしお	うずしほ
うずまき	うづまき
うずまっ	うづまつ
うずまら	うづまら
うずまり	うづまり
うずまる	うづまる
うずまれ	うづまれ
うずまろう	うづまらう
うずめ	うづめ
うずもれ	うづもれ
うずら	うづら
うずら、	うずら、
うずら。	うずら。
うずを	うづを
うず高	堆
うそぶいた	うそぶいた
うそぶいて	うそぶいて
うたい	うたひ
うたいがい	うたいがい
うたいぎな	うたいぎな
うたいくつ	うたいくつ
うたいこ	うたいこ
うたいこな	うたいこな
うたいし	うたいし
うたいした	うたいした
うたいして	うたいして
うたいせつ	うたいせつ
うたいまつ	うたいまつ
うたいやき	うたいやき
うたう	うたふ
うたうまいじゃ	うたうまいぢや
うたうまいで	うたうまいで
うたうまいな	うたうまいな
うたうまいね	うたうまいね
うたうまいの	うたうまいの
うたうまいん	うたうまいん
うたうまか	うたうまか
うたうまく	うたうまく
うたうまけれ	うたうまけれ
うたえ	うたへ
うたおう	うたはう
うたがい	うたがひ
うたがいつ	うたがひつ
うたがいつつ	うたがひつつ
うたがう	うたがふ
うたがえ	うたがへ
うたがおう	うたがはう
うたがわ	うたがは
うたごえ	うたごゑ
うたろう	うたらう
うたわざ	うたはざ
うたわず	うたはず
うたわな	うたはな
うたわぬ	うたはぬ
うたわれ	うたはれ
うたわん	うたはん
うちょうてん	うちやうてん
うちわから	うちはから
うちわからず	うちわからず
うちわからな	うちわからな
うちわが	うちはが
うちわがくに	うちわがくに
うちわがほう	うちわがはう
うちわがまま	うちわがまま
うちわがもの	うちわがもの
うちわが家	うちわが家
うちわが軍	うちわが軍
うちわが校	うちわが校
うちわが国	うちわが國
うちわが子	うちわが子
うちわが社	うちわが社
うちわが身	うちわが身
うちわが村	うちわが村
うちわが町	うちわが町
うちわが道	うちわが道
うちわが物	うちわが物
うちわが方	うちわが方
うちわだ	うちはだ
うちわで	うちはで
うちわの	うちはの
うちわのこと	うちわのこと
うちわの事	うちわの事
うちわの話	うちわの話
うちわも	うちはも
うちわを	うちはを
うったえ	うつたへ
うっとうし	うつたうし
うつむいた	うつむいた
うつむいて	うつむいて
うつろい	うつろひ
うつろう	うつろふ
うつろうと	うつらうと
うつろえ	うつろへ
うつろおう	うつろはう
うつろわ	うつろは
うつわから	うつはから
うつわで	うつはで
うつわに	うつはに
うでずもう	うでずまふ
うともう	うとまう
うなずい	うなづい
うなずか	うなづか
うなずき	うなづき
うなずく	うなづく
うなずけ	うなづけ
うなずこう	うなづかう
うばい	うばひ
うばう	うばふ
うばえ	うばへ
うばおう	うばはう
うばわ	うばは
うぶごえ	うぶごゑ
うべない	うべなひ
うべなう	うべなふ
うべなえ	うべなへ
うべなおう	うべなはう
うべなわ	うべなは
うまばえ	うまばへ
うみぼうず	うみばうず
うめいた	うめいた
うめいて	うめいて
うめがえ	うめがえ
うめき	うめき
うめきめき	うめきめき
うもう	うまう
うもういち	うもういち
うもうこんな	うもうこんな
うもうすぐ	うもうすぐ
うもうひと	うもうひと
うもうろう	うもうろう
うもう一	うもう一
うもう少	うもう少
うやまい	うやまひ
うやまう	うやまふ
うやまえ	うやまへ
うやまおう	うやまはう
うやまわ	うやまは
うらがわ	うらがは
うらごえ	うらごゑ
うらない	うらなひ
うらなう	うらなふ
うらなえ	うらなへ
うらなおう	うらなはう
うらなわ	うらなは
うらもう	うらまう
うるう	うるふ
うるおい	うるほひ
うるおう	うるほふ
うるおえ	うるほへ
うるおさ	うるほさ
うるおし	うるほし
うるおす	うるほす
うるおせ	うるほせ
うるおそう	うるほさう
うるおっ	うるほつ
うるおわ	うるほは
うるわし	うるはし
うれえ	うれへ
うろたえ	うろたへ
うろついた	うろついた
うろついて	うろついて
うわごと	うはごと
うわさ	うはさ
うわさび	うわさび
うわず	うはづ
うわずかじゃ	うわづかぢや
うわずかだ	うわづかだ
うわずかで	うわづかで
うわずかな	うわづかな
うわずかに	うわづかに
うわずかの	うわづかの
うわずっ	うはずつ
うわずら	うはずら
うわずらい	うわづらひ
うわずらう	うわづらふ
うわずらわ	うわずらは
うわずり	うはずり
うわずる	うはずる
うわずれ	うはずれ
うわずろう	うはずらう
うわついた	うはついた
うわついて	うはついて
うわつか	うはつか
うわつき	うはつき
うわつく	うはつく
うわつけ	うはつけ
うわつこう	うはつかう
うわなり	うはなり
うわばみ	うはばみ
うわまえ	うはまへ
うわ言	うは言
うんしゅう	うんしう
えがいた	ゑがいた
えがいて	ゑがいて
えがおで	ゑがほで
えがおに	ゑがほに
えがおの	ゑがほの
えがかざ	ゑがかざ
えがかず	ゑがかず
えがかな	ゑがかな
えがかぬ	ゑがかぬ
えがかれ	ゑがかれ
えがかん	ゑがかん
えがき	ゑがき
えがく	ゑがく
えがけ	ゑがけ
えがこう	ゑがかう
えがらっぽ	ゑがらっぽ
えくぼ	ゑくぼ
えぐい	ゑぐい
えぐかっ	ゑぐかつ
えぐから	ゑぐから
えぐかろう	ゑぐからう
えぐく	ゑぐく
えぐけれ	ゑぐけれ
えぐっ	ゑぐつ
えぐら	ゑぐら
えぐり	ゑぐり
えぐる	ゑぐる
えぐれ	ゑぐれ
えぐろう	ゑぐらう
えぐ味	ゑぐ味
えさが	ゑさが
えさじゃ	ゑさぢや
えさだ	ゑさだ
えさで	ゑさで
えさと	ゑさと
えさなの	ゑさなの
えさなみ	ゑさなみ
えさなん	ゑさなん
えさに	ゑさに
えさね	ゑさね
えさの	ゑさの
えさも	ゑさも
えさよ	ゑさよ
えさを	ゑさを
えじき	ゑじき
えずいた	ゑづいた
えずいて	ゑづいて
えずかざ	ゑづかざ
えずかず	ゑづかず
えずかな	ゑづかな
えずかぬ	ゑづかぬ
えずきつつ	ゑづきつつ
えずきつづ	ゑづきつづ
えずきま	ゑづきま
えずき続	ゑづき續
えずく	ゑづく
えずこう	ゑづかう
えそらごと	ゑそらごと
えのぐ	ゑのぐ
えはがき	ゑはがき
えびす	ゑびす
えらぼう	えらばう
えんきょく	ゑんきょく
えんどう	ゑんどう
えんまん	ゑんまん
えんりょ	ゑんりょ
おいおい	おひおひ
おいおい、	おいおい、
おいおい。	おいおい。
おいかえ	おひかへ
おいさき	おひさき
おいしげっ	おひしげつ
おいしげら	おひしげら
おいしげり	おひしげり
おいしげる	おひしげる
おいしげれ	おひしげれ
おいしげろう	おひしげらう
おいた	おいた
おいたち	おひたち
おいて	おいて
おいら	おいら
おいる	おいる
おいわけ	おひわけ
おういつし	わういつし
おういつす	わういつす
おうえん	おうゑん
おうおう	をうをう
おうおうにして	わうわうにして
おうかくまく	わうかくまく
おうかく膜	わうかく膜
おうぎ	あふぎ
おうさか	あふさか
おうちゃく	わうちやく
おうとつ	あふとつ
おうのう	あうなう
おうへい	わうへい
おうまがとき	あふまがとき
おうまが時	あふまが時
おうむ	あうむ
おうらい	わうらい
おえざ	をへざ
おえず	をへず
おえた	をへた
おえて	をへて
おえな	をへな
おえぬ	をへぬ
おえま	をへま
おえよ	をへよ
おえよう	をへよう
おえり	をへり
おえる	をへる
おえれ	をへれ
おえろ	をへろ
おえん	をへん
おお	おほ
おお、	おお、
おお。	おお。
おおい	おほい
おおいつつ	おほひつつ
おおいつづ	おほひつづ
おおいながら	おほひながら
おおいにな	おほひにな
おおいまく	おほひまく
おおいまし	おほひまし
おおいます	おほひます
おおいませ	おほひませ
おおいを	おほひを
おおい続	おほひ續
おおう	おほふ
おおうとし	おはうとし
おおうとす	おはうとす
おおえ	おほへ
おおおう	おほはう
おおぎょう	おほぎやう
おおごえ	おほごゑ
おおしい	ををしい
おおしかっ	ををしかつ
おおしから	ををしから
おおしかり	ををしかり
おおしかろう	ををしからう
おおしき	ををしき
おおしく	ををしく
おおしけれ	ををしけれ
おおしゅう	ををしう
おおずもう	おほずまふ
おおっ、	おお、
おおった	おほつた
おおっち	おほつち
おおって	おほつて
おおむこう	おほむかう
おおわ	おほは
おおわらい	おほわらひ
おかさ	をかさ
おかし	をかし
おかしう	をかしう
おかしか	をかしか
おかしが	をかしが
おかしき	をかしき
おかしく	をかしく
おかしけれ	をかしけれ
おかした	をかした
おかしつ	をかしつ
おかして	をかして
おかしな	をかしな
おかしま	をかしま
おかしゅう	をかしう
おかし続	をかし續
おかす	をかす
おかすれ	おかすれ
おかせば	をかせば
おかそう	をかさう
おかっぴき	をかつぴき
おかぼれ	をかぼれ
おかむら	をかむら
おかもち	をかもち
おかもと	をかもと
おがさわら	をがさはら
おがたまのき	をがたまのき
おがま	をがま
おがみ	をがみ
おがむ	をがむ
おがめ	をがめ
おがもう	をがまう
おがんじゃ	をがんぢや
おがんだ	をがんだ
おがんで	をがんで
おきわすれ	おきわすれ
おぎない	おぎなひ
おぎなう	おぎなふ
おぎなえ	おぎなへ
おぎなおう	おぎなはう
おぎなわ	おぎなは
おぎわら	をぎはら
おくびょう	おくびやう
おぐら	をぐら
おけで	をけで
おけら	をけら
おけを	をけを
おこがまし	をこがまし
おこぜ	をこぜ
おこない	おこなひ
おこなう	おこなふ
おこなえ	おこなへ
おこなおう	おこなはう
おこなわ	おこなは
おこわ	おこは
おさえ	おさへ
おさな	をさな
おさま	をさま
おさめ	をさめ
おしあい	おしあひ
おしあう	おしあふ
おしあおう	あしあはう
おしあわ	おしあは
おしい	をしい
おしえ	をしへ
おしかっ	をしかつ
おしから	をしから
おしかろう	をしからう
おしくて	をしくて
おしくも	をしくも
おしければ	をしければ
おしずもう	おしずまふ
おしどり	をしどり
おしべ	をしべ
おしま	をしま
おしまい	おしまひ
おしみ	をしみ
おしむ	をしむ
おしめば	をしめば
おしもう	をしまう
おしゅう	をしう
おしょうさ	をしやうさ
おしんじゃ	をしんぢや
おしんだ	をしんだ
おしんで	をしんで
おしんでした	おしんでした
おしんです	おしんです
おじ	をぢ
おじい	おぢい
おじおじ	おぢおぢ
おじかん	おじかん
おじぎ	おじぎ
おじけ	おぢけ
おじじ	おじじ
おじず	おぢず
おじぞうさん	おぢざうさん
おじた	おぢた
おじて	おぢて
おじな	おぢな
おじぬ	おぢぬ
おじゃま	おじやま
おじゃる	おぢやる
おじゃれ	おぢやれ
おじゃん	おぢやん
おじやじゃ	おじやぢや
おじやだ	おじやだ
おじやで	おじやで
おじやに	おじやに
おじやの	おじやの
おじやも	おじやも
おじやを	おじやを
おじょう	おぢやう
おじょうず	おじやうず
おじよう	おぢよう
おじる	おぢる
おじれば	おぢれば
おずおず	おづおづ
おそいつつ	おそひつつ
おそいつづ	おそひつづ
おそいながら	おそひながら
おそいながらも	おそひながらも
おそいまく	おそひまく
おそいまし	おそひまし
おそいます	おそひます
おそいませ	おそひませ
おそう	おそふ
おそえ	おそへ
おそおう	おそはう
おそわ	おそは
おぞうに	おざふに
おたけび	をたけび
おだまき	をだまき
おちこち	をちこち
おちょうしもの	おてうしもの
おぢま	おぢま
おっくう	おくくふ
おった	をつた
おったて	おつたて
おっち	をつち
おっちょこちょい	おつちよこちよい
おって	をつて
おってが	おつてが
おってに	おつてに
おてんとうさ	おてんたうさ
おとがい	おとがひ
おとこ	をとこ
おところ	おところ
おとずれ	おとづれ
おとつい	をとつひ
おととい	をととひ
おととし	をととし
おとめ	をとめ
おとめおき	おとめおき
おとめし	おとめし
おとめす	おとめす
おとめせ	おとめせ
おとめそで	おとめそで
おとめだて	おとめだて
おとり	をとり
おとりあげ	おとりあげ
おとりあつかい	おとりあつかひ
おとりおき	おとりおき
おとりかえ	おとりかへ
おとりきめ	おとりきめ
おとりこみ	おとりこみ
おとりちがえ	おとりちがへ
おとりはから	おとりはから
おとりよせ	おとりよせ
おとりわけ	おとりわけ
おとろえ	おとろへ
おどっ	をどつ
おどら	をどら
おどり	をどり
おどる	をどる
おどれ	をどれ
おどろう	をどらう
おなご	をなご
おなごり	おなごり
おにがわら	おにがはら
おにやらい	おにやらひ
おのこ	をのこ
おのず	おのづ
おのの	をのの
おば	をば
おばぁ	おばあ
おばあ	おばあ
おばか	おばか
おばけ	おばけ
おばば	おばば
おばんさい	おばんさい
おばんです	おばんです
おひれ	をひれ
おびれ	をびれ
おぶい	おぶひ
おぶう	おぶふ
おぶえ	おぶへ
おぶおう	おぶはう
おぶわ	おぶは
おまえ	おまへ
おみずとり	おみづとり
おみなえし	をみなへし
おめでとう	おめでたう
おもい	おもひ
おもう	おもふ
おもういち	おもういち
おもうこんな	おもうこんな
おもうすぐ	おもうすぐ
おもうひと	おもうひと
おもうろう	おもうろう
おもう一	おもう一
おもう少	おもう少
おもえ	おもへ
おもおう	おもはう
おもしろう	おもしろう
おもむい	おもむい
おもわ	おもは
およごう	およがう
おらざり	をらざり
おらざる	をらざる
おらず	をらず
おらな	をらな
おらぬ	をらぬ
おらん	をらん
おらんだ	おらんだ
おりひめ	おりひめ
おりもの	おりもの
おりもよう	おりもやう
おり地	おり地
おれざり	をれざり
おれざる	をれざる
おれざれ	をれざれ
おれず	をれず
おれずっ	おれずつ
おれずばずば	おれずばずば
おれずばり	おれずばり
おれずぶ	おれずぶ
おれずぶ	おれづぶ
おれずら	おれずら
おれずり	おれずり
おれずる	おれずる
おれずれ	おれずれ
おれずん	おれずん
おれた	をれた
おれたいやき	おれたいやき
おれたた	おれたた
おれただ	おれただ
おれたち	おれたち
おれたまたま	おれたまたま
おれたまに	おれたまに
おれて	をれて
おれてなず	おれてなづ
おれてら	おれてら
おれてれ	おれてれ
おれない	をれない
おれなかっ	をれなかつ
おれなかろう	をれなからう
おれなく	をれなく
おれなけれ	をれなけれ
おれぬ	をれぬ
おれば	をれば
おればか	おればか
おればち	おればち
おればっ	おればつ
おればねに	おればねに
おれまし	をれまし
おれます	をれます
おれませ	をれませ
おれよう	をれよう
おれる	をれる
おれれ	をれれ
おれろ	をれろ
おろう	をらう
おろがま	をろがま
おろがみ	をろがみ
おろがむ	をろがむ
おろがめ	をろがめ
おろがもう	をろがまう
おろがん	をろがん
おろち	をろち
おわい	をわい
おわし	おはし
おわす	おはす
おわっ	をはつ
おわった	をはつた
おわっち	をはつち
おわって	をはつて
おわっと	をはつと
おわらざ	をはらざ
おわらず	をはらず
おわらな	をはらな
おわらぬ	をはらぬ
おわらん	をはらん
おわり	をはり
おわる	をはる
おわれば	をはれば
おわろう	をはらう
おんせん	をんせん
おんな	をんな
おんみょう	おんみやう
お目出とう	お目出たう
かいおう星	かいわう星
かいがいし	かひがひし
かいた	かいた
かいづか	かひづか
かいて	かいて
かいばしら	かひばしら
かいやき	かひやき
かいよう	くわいやう
かいらい	くわいらい
かいわれ	かひわれ
かい焼	かひ焼
かえがき	かえがき
かえらざ	かへらざ
かえらず	かへらず
かえらな	かへらな
かえらぬ	かへらぬ
かえり	かへり
かえる	かへる
かえれ	かへれ
かえろう	かへらう
かおり	かをり
かおる	かをる
かおれば	かをれば
かおろう	かをらう
かかえ	かかへ
かかずらい	かかづらひ
かかずらう	かかづらふ
かかずらえ	かかづらへ
かかずらおう	かかづらはう
かかずらっ	かかづらつ
かかずらわ	かかづらは
かかわ	かかは
かがもう	かがまう
かがもういち	かがもういち
かがもうこんな	かがもうこんな
かがもうすぐ	かがもうすぐ
かがもうひと	かがもうひと
かがもうろう	かがもうろう
かがもう一	かがもう一
かがもう少	かがもう少
かぎかっこ	かぎくわつこ
かくざとう	かくざたう
かくまい	かくまひ
かくまう	かくまふ
かくまえ	かくまへ
かくまおう	かくまはう
かくまわ	かくまは
かくれんぼ	かくれんばう
かくれんぼう	かくれんばう
かぐわし	かぐはし
かけごえ	かけごゑ
かけずっ	かけづつ
かけずら	かけづら
かけずり	かけづり
かけずる	かけづる
かけずれ	かけづれ
かけずろう	かけづらう
かげぼうし	かげぼふし
かげろう	かげろふ
かこい	かこひ
かこう	かこふ
かこうと	かかうと
かこうにも	かかうにも
かこうもの	かかうもの
かこえど	かこへど
かこえば	かこへば
かこおう	かこはう
かこわず	かこはず
かこわな	かこはな
かこわぬ	かこはぬ
かこわん	かこはん
かさついた	かさついた
かさついて	かさついて
かしずいた	かしづいた
かしずいて	かしづいて
かしずか	かしづか
かしずき	かしづき
かしずく	かしづく
かしずけ	かしづけ
かしずこう	かしづかう
かしわ	かしは
かじかもう	かじかまう
かじきまぐろ	かぢきまぐろ
かじとり	かぢとり
かじや	かぢや
かじ取り	かぢ取り
かすがい	かすがひ
かすもう	かすまう
かずいた	かづいた
かずいて	かづいて
かずら	かづら
かせごう	かせがう
かぞえ	かぞへ
かたずを	かたづを
かたらい	かたらひ
かたらう	かたらふ
かたらえ	かたらへ
かたらおう	かたらはう
かたらわ	かたらは
かたわ	かたは
かっけ	かくけ
かっこ	くわつこ
かっこいー	かつかういい
かっこいい	かつかういい
かっこよい	かつかうよい
かっこよか	かつかうよか
かっこよく	かつかうよく
かっこよけ	かつかうよけ
かったつ	くわつたつ
かつお	かつを
かつもくし	くわつもくし
かつもくす	くわつもくす
かどわか	かどはか
かないまし	かなひまし
かないます	かなひます
かないませ	かなひませ
かなう	かなふ
かなえ	かなへ
かなおう	かなはう
かなきりごえ	かなきりごゑ
かなわ	かなは
かのじょ	かのぢよ
かばい	かばひ
かばう	かばふ
かばえ	かばへ
かばおう	かばはう
かばわ	かばは
かぶりついた	かぶりついた
かぶりついて	かぶりついて
かまい	かまひ
かまう	かまふ
かまえ	かまへ
かまおう	かまはう
かまわ	かまは
かみついた	かみついた
かみついて	かみついて
かもい	かもゐ
かゆい	かゆい
かよい	かよひ
かよう	かよふ
かようで	かやうで
かような	かやうな
かように	かやうに
かよえ	かよへ
かよおう	かよはう
かよわざ	かよはざ
かよわす	かよはす
かよわず	かよはず
かよわせ	かよはせ
かよわそう	かよはさう
かよわそうな	かよわさうな
かよわぬ	かよはぬ
かよわん	かよはん
からいうと	からいふと
からいうなら	からいふなら
からいうなれば	からいふなれば
からいえば	からいへば
からかい	からかひ
からかう	からかふ
からかえ	からかへ
からかおう	からかはう
からかわ	からかは
からすがい	からすがひ
からならい	からならひ
からならう	からならふ
からならえ	からならえ
からみついた	からみついた
からみついて	からみついて
からもう	からまう
からもういち	からもういち
からもうこんな	からもうこんな
からもうすぐ	からもうすぐ
からもうひと	からもうひと
からもうろう	からもうろう
からもう一	からもう一
からもう少	からもう少
かりんとう	くわりんたう
かれおばな	かれをばな
かわいい	かはいい
かわいか	かはいか
かわいが	かはいが
かわいく	かはいく
かわいけれ	かはいけれ
かわいそう	かはいさう
かわいらし	かはいらし
かわうそ	かはうそ
かわさざ	かはさざ
かわさず	かはさず
かわさな	かはさな
かわさぬ	かはさぬ
かわさん	かはさん
かわし	かはし
かわしが	かわしが
かわしに	かわしに
かわしの	かわしの
かわしを	かわしを
かわす	かはす
かわず	かはづ
かわせ	かはせ
かわせみ	かはせみ
かわそう	かはそう
かわたれどき	かはたれどき
かわたろう	かはたらう
かわった	かはつた
かわっち	かはつち
かわって	かはつて
かわのながれ	かはのながれ
かわむこう	かはむかう
かわや	かはや
かわゆい	かはいい
かわゆい	かはゆい
かわゆう	かはいう
かわゆか	かはいか
かわゆく	かはいく
かわゆけれ	かはいけれ
かわら	かはら
かわり	かはり
かわる	かはる
かわるがわる	かはるがはる
かわれ	かはれ
かわれら	かわれら
かわれわれ	かわれわれ
かわろう	かはらう
かわをむ	かはをむ
かわを剥	かはを剥
かんおけ	くわんをけ
かんがえ	かんがへ
かんきり	くわんきり
かんした	くわんした
かんして	くわんして
かんしない	くわんしない
かんしまし	くわんしまし
かんします	くわんします
かんしませ	くわんしませ
かんしよう	くわんしよう
かんする	くわんする
かんすれば	くわんすれば
かんせず	くわんせず
かんせぬ	くわんせぬ
かんづめ	くわんづめ
かんぬき	くわんぬき
かんぴょう	かんぺう
かんぺき	くわんぺき
かんむりょう	かんむりやう
がいなくて	がゐなくて
がえらざ	がへらざ
がえらず	がへらず
がえらな	がへらな
がえり	がへり
がえりにつ	がえりにつ
がえりにのこ	がえりにのこ
がえりに残	がえりに残
がえりに付	がえりに附
がえりのうち	がえりのうち
がえりのところ	がえりのところ
がえりの内	がえりの内
がえる	がへる
がえれ	がへれ
がえろう	がへらう
がかえ	がかへ
がかえらぬ	がへらぬ
がたいずれ	がたいずれ
がたついた	がたついた
がたついて	がたついて
がっきゅういいん	がくきふゐゐん
がっこう	がくかう
がっついた	がつついた
がっついて	がつついて
がつお	がつを
がない	がない
がならい	がならひ
がならう	がならう
がならえ	がならえ
がにない	がになひ
がになう	がになふ
がになえ	がになへ
がになおう	がになはう
がになわ	がになは
がのう	がなう
がのう。	がのう。
がびょう	ぐわびやう
がまう	がまふ
がまえ	がまへ
がゆい	がゆい
がよいを	がよひを
がらんどう	がらんだう
がれきと	ぐわれきと
がれきの	ぐわれきの
がろう	がらう
がわしい	がはしい
がわしかっ	がはしかつ
がわしからざ	がはしからざ
がわしからず	がはしからず
がわしからぬ	がはしからぬ
がわしかろう	がはしからう
がわしき	かはしき
がわしく	がはしく
がわしけれ	がはしけれ
がわしゅう	がはしう
がわりじゃ	がはりぢや
がわりだ	がはりだ
がわりで	がはりで
がわりな	がはりな
がわりにし、	がはりにし、
がわりにした	がはりにした
がわりにしつ	がはりにしつ
がわりにして	がはりにして
がわりにしな	がはりにしな
がわりにしま	がはりにしま
がわりにしよう	がはりにしよう
がわりにする	がはりにする
がわりにすれ	がはりにすれ
がわりにせざ	がはりにせざ
がわりにせず	がはりにせず
がわりにせぬ	がはりにせぬ
がわりにせよ	がはりにせよ
がわりにつか	がはりにつか
がわりに使	がはりに使
がわりね	がはりね
がわりの	がはりの
がわりよ	がはりよ
がんこ	ぐわんこ
がんじょう	ぐわんじやう
がんぜない	ぐわんぜない
がんぜなかっ	ぐわんぜなかつ
がんぜなかろ	ぐわんぜなかろ
がんぜなき	ぐわんぜなき
がんぜなく	ぐわんぜなく
がんぜなけれ	ぐわんぜなけれ
がんぜなし	ぐわんぜなし
がんぜのう	ぐわんぜのう
がんとして	ぐわんとして
きあい	きあひ
きあう	きあふ
きあえ	きあへ
きあおう	きあはう
きあわ	きあは
きいた	きいた
きいて	きいて
きかんぼう	きかんばう
きざもう	きざまう
きざわし	きざはし
きずいた	きづいた
きずいて	きづいて
きずか	きづか
きずが	きづが
きずき	きづき
きずく	きづく
きずけ	きづけ
きずこう	きづかう
きずじゃ	きづじや
きずだ	きづだ
きずつい	きづつい
きずつか	きづつか
きずつき	きづつき
きずつく	きづつく
きずつけ	きづつけ
きずつこう	きづつかう
きずで	きづで
きずな	きづな
きずは	きづは
きずも	きづも
きずを	きづを
きそい	きそひ
きそう	きそふ
きそうじゃ	きさうぢや
きそうだ	きさうだ
きそうで	きさうで
きそうな	きさうな
きそうに	きさうに
きそうね	きさうね
きそうよ	きさうよ
きそえば	きそへば
きそおう	きそはう
きそわ	きそは
きたえ	きたへ
きのう	きのふ
きゅうかなづかい	きうかなづかひ
きゅうかんちょう	きうくわんてう
きゅうきゅうと	きふきふと
きゅうじゃ	きうぢや
きゅうだ	きうだ
きゅうで	きうで
きゅうな	きうな
きゅうに	きうに
きゅうね	きうね
きゅうり	きうり
きょう	けふ
きょうきょう	きようきよう
きょうだい	きやうだい
きょうちくとう	けふちくたう
きょうれつ	きやうれつ
きよみず	きよみづ
きらい	きらひ
きらう	きらふ
きらえ	きらへ
きらおう	きらはう
きらめいた	きらめいた
きらめいて	きらめいて
きらわ	きらは
きりょう	きりやう
きれあじ	きれあぢ
きわめて	きはめて
きんめだい	きんめだひ
ぎだゆう	ぎだいふ
ぎゅうにゅう	ぎうにゆう
ぎょう	ぎやう
ぎょうさん	ぎやうさん
ぎらい	ぎらひ
くいしんぼう	くひしんばう
くい込	くひ込
くい止	くひ止
くじいた	くじいた
くじいて	くじいて
くじら	くぢら
くすもう	くすまう
くず	くづ
くずーっと	くずーつと
くずあん	くずあん
くずいぶん	くずいぶん
くずうずう	くづうづう
くずうっと	くずうつと
くずかずか	くづかづか
くずきり	くずきり
くずきんずきん	くづきんづきん
くずけずけ	くづけづけ
くずしっ	くずしつ
くずしん	くずしん
くずたずた	くずたずた
くずだんご	くずだんご
くずっしり	くずつしり
くずっと	くずつと
くずどーん	くずどーん
くずどん	くずどん
くずばずば	くずばずば
くずばっ	くずばつ
くずばり	くずばり
くずぶずぶ	くずぶずぶ
くずぶぬれ	くずぶぬれ
くずぶの	くずぶの
くずぶ濡れ	くずぶ濡れ
くずぼら	くずぼら
くずまんじゅう	くずまんぢゆう
くずもち	くずもち
くずら	くずら
くずらずら	くずらずら
くずり	くずり
くずる	くずる
くずるずる	くずるずる
くずれ込	くずれ込
くずわい	くずわい
くずん	くずん
くず湯	くず湯
くず餅	くず餅
くず饅頭	くず饅頭
くだいた	くだいた
くだいて	くだいて
くださいますよう	くださいますやう
くっついた	くつついた
くっついて	くつついて
くつがえ	くつがへ
くつわ	くつは
くづきづき	くづきづき
くもうじゃ	くまうぢや
くもうでは	くまうでは
くもうと	くまうと
くもうにも	くまうにも
くらい	くらゐ
くらいつつ	くらひつつ
くらいながら	くらひながら
くらいので	くらいので
くらいまく	くらひまく
くらいまし	くらひまし
くらいます	くらひます
くらいませ	くらひませ
くらいもので	くらいもので
くらいん	くらいん
くらう	くらふ
くらえ	くらへ
くらおう	くらはう
くらもう	くらまう
くらわざり	くらはざり
くらわざる	くらはざる
くらわざれ	くらはざれ
くらわず	くらはず
くらわな	くらはな
くらわぬ	くらはぬ
くらわん	くらはん
くるおしい	くるほしい
くるおしかっ	くるほしかつ
くるおしから	くるほしから
くるおしかろう	くるほしからう
くるおしき	くるほしき
くるおしく	くるほしく
くるおしければ	くるほしければ
くるしもう	くるしまう
くるめいた	くるめいた
くるめいて	くるめいて
くるわさ	くるはさ
くるわし	くるはし
くるわす	くるはす
くるわせ	くるはせ
くるわそう	くるはさう
くろざとう	くろざたう
くろしお	くろしほ
くろだい	くろだひ
くわい	くわゐ
くわえ	くはへ
くわし	くはし
くわしが	くわしが
くわしじゃ	くわしぢや
くわしづかみ	くわしづかみ
くわしで	くわしで
くわしに	くわしに
くわしの	くわしの
くわしは	くわしは
くわしを	くわしを
くわす	くはす
くわせ	くはせ
くわそう	くはさう
くわだて	くはだて
くわれ	くはれ
くわれら	くわれら
くわれわれ	くわれわれ
くわわっ	くははつ
くわわら	くははら
くわわり	くははり
くわわる	くははる
くわわれ	くははれ
くわわろう	くははらう
くんずほぐれつ	くんづほぐれつ
ぐあい	ぐあひ
ぐずついた	ぐづついた
ぐずついて	ぐづついて
ぐつわ	ぐつは
ぐびじんそう	ぐびじんさう
ぐもう	ぐまう
ぐもういち	ぐもういち
ぐもうこんな	ぐもうこんな
ぐもうすぐ	ぐもうすぐ
ぐもうひと	ぐもうひと
ぐもうろう	ぐもうろう
ぐもう一	ぐもう一
ぐもう少	ぐもう少
ぐらい	ぐらゐ
ぐらついた	ぐらついた
ぐらついて	ぐらついて
ぐるい	ぐるひ
ぐるわし	ぐるはし
ぐんじょう	ぐんじやう
けおり	けおり
けがらわ	けがらは
けじめ	けぢめ
けずっ	けづつ
けずら	けづら
けずり	けづり
けずる	けづる
けずれ	けづれ
けずろう	けづらう
けちんぼう	けちんばう
けむくじゃら	けむくぢやら
けわしい	けはしい
けわしか	けはしか
けわしき	けはしき
けわしく	けはしく
けわしけれ	けはしけれ
けわしゅう	けはしう
げじげじ	げぢげぢ
こいこがれ	こひこがれ
こいごころ	こひごころ
こいしい	こひしい
こいしか	こひしか
こいしく	こひしく
こいしけれ	こひしけれ
こいしゅう	こひしう
こいねがい	こひねがひ
こいねがう	こひねがふ
こいねがえ	こひねがへ
こいねがおう	こひねがはう
こいねがっ	こひねがつ
こいねがわ	こひねがは
こいのぼり	こひのぼり
こいぶみ	こひぶみ
こいわずらい	こひわずらひ
こうかつ	かうくわつ
こうこうた	くわうくわうた
こうこうと	くわうくわうと
こうのとり	こふのとり
こうもり	かうもり
こおっ	こほつ
こおどり	こをどり
こおらざ	こほらざ
こおらず	こほらず
こおらな	こほらな
こおらぬ	こほらぬ
こおらん	こほらん
こおり	こほり
こおる	こほる
こおれば	こほれば
こおろう	こほろう
こげた臭い	こげた臭ひ
こげついた	こげついた
こげついて	こげついて
こげる臭い	こげる臭ひ
こころばえ	こころばへ
こごう	こがう
こごもう	こごまう
こさえ	こさへ
こしょう	こせう
こしらえ	こしらへ
こずえ	こずゑ
こそごう	こそがう
こそばゆい	こそばゆい
こたえ	こたへ
こだわっ	こだはつ
こだわら	こだはら
こだわり	こだはり
こだわる	こだはる
こだわれ	こだはれ
こだわろう	こだはらう
こちょうらん	こてふらん
こづいた	こづいた
こづいて	こづいて
こないだ	こなひだ
こないだろ	こないだら
このうえ	このうへ
こびりついた	こびりついた
こびりついて	こびりついて
こまねいた	こまねいた
こまねいて	こまねいて
こめだわら	こめだはら
こもう	こまう
こもういち	こもういち
こもうこんな	こもうこんな
こもうすぐ	こもうすぐ
こもうひと	こもうひと
こもうろう	こもうろう
こもう一	こもう一
こもう少	こもう少
こらえ	こらへ
ころぼう	ころばう
こわい	こはい
こわいろ	こわいろ
こわかっ	こはかつ
こわからず	こはからず
こわかろう	こはからう
こわがっ	こはがつ
こわがら	こはがら
こわがり	こはがり
こわがる	こはがる
こわがれ	こはがれ
こわがろう	こはがらう
こわくて	こはくて
こわくな	こはくな
こわけれ	こはけれ
こわごわ	こはごは
こわば	こはば
こわもて	こはもて
こわれ	こはれ
こんぼう	こんばう
ごうつくばり	がふつくばり
ごうつくばる	がふつくばる
ごうはら	ごふはら
ごえもん	ごゑもん
ごおり	ごほり
ごくどう	ごくだう
ございま	ございま
ごしらえ	ごしらへ
ごぞうろっぷ	ござうろくぷ
ごたえ	ごたへ
ごたついた	ごたついた
ごたついて	ごたついて
ごふじょう	ごふじやう
ごぼう	ごばう
ごわごわ	ごはごは
ごわついた	ごはついた
ごわついて	ごはついて
ごわつか	ごはつか
ごわつき	ごはつき
ごわつく	ごはつく
ごわつけ	ごはつけ
ごわつこう	ごはつかう
さいた	さいた
さいて	さいて
さいなもう	さいなまう
さいのかわら	さいのかはら
さいま	さいま
さいわい	さいはひ
さえがいまひとつ	さえがいまひとつ
さえがすこし	さえがすこし
さえがな	さえがな
さえがもう	さえがもう
さえが今ひとつ	さえが今ひとつ
さえが少し	さえが少し
さえず	さえず
さえてき	さえてき
さえてく	さえてく
さえてこ	さえてこ
さえて来	さえて来
さえぬ	さえぬ
さえまし	さえまし
さえます	さえます
さえませ	さえませ
さおり	さおり
さかいに	さかひに
さかいめ	さかひめ
さかえ	さかえ
さかずき	さかづき
さからい	さからひ
さからいうこと	さからいふこと
さからいうと	さからいふと
さからいうところ	さからいふところ
さからいうな	さからいふな
さからいえば	さからいへば
さからう	さからふ
さからえ	さからへ
さからおう	さからはう
さからわ	さからは
さけびごえ	さけびごゑ
さけぼう	さけばう
さげすもう	さげすまう
ささやいた	ささやいた
さざめいて	さざめいて
さざんか	さざんくわ
さすらい	さすらひ
さすらう	さすらふ
さすらえ	さすらへ
さすらおう	さすらはう
さすらわ	さすらは
さずかっ	さづかつ
さずから	さづから
さずかり	さづかり
さずかる	さづかる
さずかれ	さづかれ
さずかろう	さづからう
さずけ	さづけ
さそい	さそひ
さそう	さそふ
さそえ	さそへ
さそおう	さそはう
さそわ	さそは
さっか傷	さつくわ傷
さっそうたる	さつさうたる
さっそうと	さつさうと
さておいた	さておいた
さておいて	さておいて
さなえ	さなへ
さばいた	さばいた
さばいて	さばいて
さばおり	さばをり
さびついた	さびついた
さびついて	さびついて
さまよい	さまよひ
さまよう	さまよふ
さまよえ	さまよへ
さまよおう	さまよはう
さまよわ	さまよは
さむらい	さむらひ
さもう	さまう
さもういち	さもういち
さもうこんな	さもうこんな
さもうすぐ	さもうすぐ
さもうひと	さもうひと
さもうろう	さもうろう
さもう一	さもう一
さもう少	さもう少
さやえんどう	さやゑんどう
さらい	さらひ
さらいかが	さらいかが
さらいかほど	さらいかほど
さらいくつ	さらいくつ
さらいくら	さらいくら
さらいただ	さらいただ
さらいため	さらいため
さらいっぱい	さらいつぱい
さらいっぺん	さらいつぺん
さらいつまで	さらいつまで
さらいつも	さらいつも
さらいろいろ	さらいろいろ
さらう	さらふ
さらえ	さらへ
さらお	さらは
さらさら	さらさら
さらばえ	さらばへ
さらわれ	さらはれ
さるしばい	さるしばゐ
さわいだ	さわいだ
さわいで	さわいで
さわが	さわが
さわぎ	さわぎ
さわぐ	さわぐ
さわげ	さわげ
さわごう	さわがう
さわさわ	さわさわ
さわらび	さわらび
さわり	さはり
さんしょ	さんせう
さんしょう	さんせう
さんしょううお	さんせううを
さんしょうだゆう	さんせうだいふ
さんずのかわ	さんづのかは
ざかい	ざかひ
ざむらい	ざむらひ
ざらい	ざらひ
ざらえ	ざらへ
ざらついた	ざらついた
ざらついて	ざらついて
ざわついた	ざわついた
ざわついて	ざわついて
ざわめいた	ざわめいた
ざわめいて	ざわめいて
ざわり	ざはり
ざんぼう	ざんばう
しいたけ	しひたけ
しいたげ	しひたげ
しいて	しひて
しいの木	しひの木
しお、こしょう	しほ、こせう
しお・こしょう	しほ・こせう
しおあじ	しほあぢ
しおかぜ	しほかぜ
しおから	しほから
しおこしょう	しほこせう
しおさい	しほさひ
しおざけ	しほざけ
しおしおと	しをしをと
しおせんべい	しほせんべい
しおどき	しほどき
しおひがり	しほひがり
しおらし	しをらし
しおり	しをり
しおれ	しをれ
しおれが	しおれが
しおれで	しおれで
しおれの	しおれの
しおれは	しおれは
しおれも	しおれも
しおれを	しおれを
しおを	しほを
しがみついた	しがみついた
しがみついて	しがみついて
しこうして	しかうして
しごいた	しごいた
しごいて	しごいて
しずもう	しづまう
しそちょう	しそてう
したあじ	したあぢ
したうえ	したうへ
したがい	したがひ
したがいつ	したがひつ
したがいつつ	したがひつつ
したがう	したがふ
したがえ	したがへ
したがおう	したがはう
したがわ	したがは
したせい	したせゐ
したなめずり	したなめづり
したにしいて	したにしいて
したりがお	したりがほ
しちてんばっとう	しちてんばつたう
しちめんちょう	しちめんてう
しつような	しつえうな
しつように	しつえうに
しつらい	しつらひ
しつらえ	しつらへ
しないつつ	しなひつつ
しないまく	しなひまく
しないまし	しなひまし
しないます	しなひます
しないませ	しなひませ
しなう	しなふ
しなえ	しなへ
しなおう	しなはう
しなわ	しなは
しのごう	しのがう
しのぼう	しのばう
しばたいた	しばたいた
しばたいて	しばたいて
しぶいた	しぶいた
しぶいて	しぶいて
しまい	しまひ
しまう	しまふ
しまうま	しまうま
しまえ	しまへ
しまえび	しまえび
しまおう	しまはう
しまだい	しまだひ
しまわ	しまは
しみついた臭い	しみついた臭ひ
しめじ	しめぢ
しめなわ	しめなは
しもうた	しまうた
しもうて	しまうて
しゃがもう	しやがまう
しゃがれごえ	しやがれごゑ
しゃれこうべ	されかうべ
しゅーしゅー	しうしう
しゅうげん	しうげん
しゅうござ	しうござ
しゅうしゅう	しうしう
しゅうて	しうて
しゅうとめ	しうとめ
しゅうない	しうない
しゅうなっ	しうなつ
しゅうなり	しうなり
しゅうなる	しうなる
しゅうなれ	しうなれ
しゅうなろう	しうならう
しょいこま	しよひこま
しょいこみ	しよひこみ
しょいこむ	しよひこむ
しょいこめ	しよひこめ
しょいこもう	しよいこまう
しょいこん	しよひこん
しょい込	しよひ込
しょうが	しやうが
しょうがっこう	せうがつかう
しょうがつ	しやうぐわつ
しょうけつ	しやうけつ
しょうこり	しやうこり
しょうしゃな	せうしやな
しょうじ	しやうじ
しょうず	しやうず
しょうちん	せうちん
しょうのう	しやうなう
しょうぶ	しやうぶ
しょうべん	せうべん
しょうもない	しやうもない
しょうゆ	しやうゆ
しょう油	しやう油
しょぼついた	しよぼついた
しょぼついて	しよぼついて
しらうお	しらうを
しらかわよふね	しらははよふね
しらぬい	しらぬひ
しりにしいて	しりにしいて
しろうと	しろうと
しろたえ	しろたへ
しわがれ	しはがれ
しわすの	しはすの
しわぶい	しはぶい
しわぶか	しはぶか
しわぶき	しはぶき
しわぶく	しはぶく
しわぶけ	しはぶけ
しわぶこう	しはぶかう
しんこきゅう	しんこきふ
じいさん	ぢいさん
じかに	ぢかに
じきじき	ぢきぢき
じくじたる	ぢくぢたる
じごく	ぢごく
じじ	ぢぢ
じぞう	ぢざう
じたばた	ぢたばた
じだんだ	ぢだんだ
じっこん	ぢつこん
じならし	ぢならし
じべたに	ぢべたに
じまい	じまひ
じみょう	じみよう
じゃーじゃー	じやあじやあ
じゃあじゃあ	じやあじやあ
じゃい	ぢやひ
じゃう	ぢやふ
じゃうじゃ	じやうじや
じゃえ	ぢやへ
じゃおう	ぢやはう
じゃかじゃか	じやかじやか
じゃかすか	じやかすか
じゃがいも	じやがいも
じゃがイモ	じやがイモ
じゃが芋	じやが芋
じゃきじゃき	じやきじやき
じゃこ	じやこ
じゃこう	じやかう
じゃじゃ	じやじや
じゃっかん	じやくかん
じゃっき	じやくき
じゃのめ	じやのめ
じゃばら	じやばら
じゃぱん	じやぱん
じゃぶじゃぶ	じやぶじやぶ
じゃぶん	じやぶん
じゃぼん	じやぼん
じゃま	じやま
じゃらじゃら	じやらじやら
じゃりじゃり	じやりじやり
じゃれ	じやれ
じゃわ	じやは
じゃんけん	じやんけん
じゃんじゃか	じやんじやか
じゃんじゃん	じやんじやん
じゅうしまつ	じふしまつ
じゅうしょ	ぢゆうしよ
じゅうじゅうあやま	ぢゆうぢゆうあやま
じゅうじゅうおわび	ぢゆうぢゆうおわび
じゅうじゅうお詫び	ぢゆうぢゆうお詫び
じゅうじゅうわか	ぢゆうぢゆうわか
じゅうじゅうわび	ぢゆうぢゆうわび
じゅうじゅう解	ぢゆうぢゆう解
じゅうじゅう謝	ぢゆうぢゆう謝
じゅうじゅう承	ぢゆうぢゆう承
じゅうじゅう判	ぢゆうぢゆう判
じゅうじゅう分	ぢゆうぢゆう分
じゅうじゅう詫	ぢゆうぢゆう詫
じゅうたんをしいて	じゅうたんをしいて
じゅうとめ	じうとめ
じゅぎょう	じゆげふ
じょうさま	じやうさま
じょうさん	じやうさん
じょうず	じやうず
じょうぶ	じやうぶ
じょうまえ	ぢやうまへ
じょうゆ	じやうゆ
じょう油	じやう油
じょう様	じやう様
じりじり	ぢりぢり
じり安	ぢり安
じり高	ぢり高
じり貧	ぢり貧
じんちょうげ	ぢんちやうげ
じんとり	ぢんとり
すいがら	すひがら
すいた	すいた
すいつつ	すひつつ
すいつづけ	すひつづけ
すいて	すいて
すいながら	すひながら
すいまくっ	すひまくつ
すいまくら	すひまくら
すいまくり	すひまくり
すいまくる	すひまくる
すいまくれ	すひまくれ
すいまくろう	すひまくらう
すいました	すひました
すいまして	すひまして
すいましょう	すひませう
すいます	すひます
すいますんで	すひますんで
すいませんか	すひませんか
すい殻	すひ殻
すい続け	すひ續け
すえたような臭い	すえたような臭ひ
すえた臭い	すえた臭ひ
すがりついた	すがりついた
すがりついて	すがりついて
すくい	すくひ
すくう	すくふ
すくえ	すくへ
すくおう	すくはう
すくわ	すくは
すごもう	すごまう
すすごう	すすがう
すすもう	すすまう
すっとんきょう	すつとんきやう
すなお	すなほ
すなわち	すなはち
すみずみ	すみずみ
すもうとり	すまふとり
すもうを	すまふを
するうえ	するうへ
するせい	するせゐ
すわけだ	すわけだ
すわけで	すわけで
すわけな	すわけな
すわった	すわつた
すわっち	すわつち
すわって	すわつて
すわら	すわら
すわり	すわり
すわる	すわる
すわれ	すわれ
すわろう	すわらう
ずーずー弁	ずうずう辯
ずうずうし	づうづうし
ずうずう弁	ずうずう辯
ずうたい	づうたい
ずかずか	づかづか
ずきずき	づきづき
ずきん	づきん
ずけずけ	づけづけ
ずさんだ	づさんだ
ずさんで	づさんで
ずさんな	づさんな
ずさんに	づさんに
ずさんの	づさんの
ずしずし	ずしずし
ずだぶくろ	づだぶくろ
ずだ袋	づだ袋
ずっといたって	ずつとゐたつて
ずぬけた	づぬけた
ずぬけて	づぬけて
ずぶずぶ	ずぶずぶ
ずぶぬれ	ずぶぬれ
ずぶ濡れ	ずぶ濡れ
ずもう	ずまふ
せーかつ	せいくわつ
せいかつ	せいくわつ
せいた	せいた
せいて	せいて
せいねんがっぴ	せいねんぐわつぴ
せがもう	せがまう
せっかい	せつかひ
せっついた	せつついた
せっついて	せつついて
せわしい	せはしい
せわしか	せはしか
せわしき	せはしき
せわしく	せはしく
せわしけれ	せはしけれ
せわしな	せはしな
せんえつ	せんゑつ
せんこう	せんかう
ぜいたく	ぜいたく
ぜっこうちょー	ぜつかうてう
ぜっこうちょう	ぜつかうてう
ぜつみょう	ぜつめう
ぜわしい	ぜはしい
ぜわしか	ぜはしか
ぜわしき	ぜはしき
ぜわしく	ぜはしく
ぜわしけ	ぜはしけ
そーゆー	さういふ
そうこう	さうかう
そうじ	さうぢ
そうぞうし	さうざうし
そうろう	さうらふ
そえず	そへず
そえた	そへた
そえつつ	そへつつ
そえつづ	そへつづ
そえて	そへて
そえない	そへない
そえなかっ	そへなかつ
そえながら	そへながら
そえなく	そへなく
そえなけれ	そへなけれ
そえぬ	そへぬ
そえまく	そへまく
そえまし	そへまし
そえます	そへます
そえませ	そへませ
そえもの	そへもの
そえよう	そへよう
そえる	そへる
そえれば	そへれば
そえん	そへん
そくみょう	そくめう
そぐい	そぐひ
そぐいきおい	そぐいきほひ
そぐう	そぐふ
そぐえ	そぐへ
そぐおう	そぐはう
そぐわざ	そくはざ
そぐわず	そぐはず
そぐわな	そぐはな
そぐわぬ	そぐはぬ
そぐわん	そぐはん
そこいじが	そこいぢが
そこいじの	そこいぢの
そこない	そこなひ
そこなう	そこなふ
そこなえ	そこなへ
そこなおう	そこなはう
そこなわ	そこなは
そそごう	そそがう
そだとう。	そだたう。
そだとうか	そだたうか
そだとうが	そだたうが
そだとうじゃ	そだたうぢや
そだとうぞ	そだたうぞ
そだとうで	そだたうで
そだとうと	そだたうと
そだとうに	そだたうに
そだとうね	そだとうね
そだとうや	そだたうや
そだとうよ	そだたうよ
そっこー	そくこう
そっこく	そくこく
そつぎょう	そつげふ
そなえ	そなへ
そなえよう	そなへよう
そなわっ	そなはつ
そなわら	そなはら
そなわり	そなはり
そなわる	そなはる
そなわれ	そなはれ
そなわろう	そなはろう
そのうえ	そのうへ
そむいた	そむいた
そむいて	そむいて
そめいよしの	そめゐよしの
そよごう	そよがう
そらもよう	そらもやう
それじゃ	それぢや
そろい	そろひ
そろう	そろふ
そろえ	そろへ
そろおう	そろはう
そろわ	そろは
そわそわ	そはそは
そわつい	そはつい
そわつか	そはつか
そわつき	そはつき
そわつく	そはつく
そわつけば	そはつけば
そわつこう	そはつかう
そんじょ	そんぢよ
ぞうきん	ざふきん
ぞうすい	ざふすい
ぞうり	ざうり
ぞこない	ぞこなひ
ぞこなう	ぞこなふ
ぞこなえ	ぞこなへ
ぞこなおう	ぞこなはう
ぞこなわ	ぞこなは
ぞろい	ぞろひ
ぞろえ	ぞろへ
たあいなくて	たあいなくて
たいた	たいた
たいて	たいて
たいらげ	たひらげ
たいらだ	たひらだ
たいらで	たひらで
たいらな	たひらな
たいらに	たひらに
たいらの	たひらの
たえざる	たえざる
たえず	たえず
たえぬ	たえぬ
たおさ	たふさ
たおさえ	たおさへ
たおさき	たおさき
たおさすり	たおさすり
たおさない子	たをさない子
たおさなご	たをさなご
たおさな子	たをさな子
たおさむ	たおさむ
たおさら	たおさら
たおし	たふし
たおしい	たをしい
たおしえ	たおしへ
たおしお	たおしお
たおしく	たをしく
たおしどり	たをしどり
たおしべ	たをしべ
たおしぼり	たおしぼり
たおしめ	たおしめ
たおしゃ	たおしゃ
たおしゃか	たおしやか
たおしら	たおしら
たおしん	たおしん
たおす	たふす
たおすそ	たおすそ
たおすみ	たおすみ
たおすわり	たおすわり
たおせ	たふせ
たおせおせ	たおせおせ
たおせち	たおせち
たおそう	たふさう
たおやか	たをやか
たおやめ	たをやめ
たおれ	たふれ
たおれから	たおれから
たおれが	たおれが
たおれさま	たおれさま
たおれしか	たおれしか
たおれだ	たおれだ
たおれで	たおれで
たおれの	たおれの
たおれは	たおれは
たおれも	たおれも
たおれら	たおれら
たおれを	たおれを
たおれ様	たおれ様
たかしお	たかしほ
たがい	たがひ
たがいつ	たがひつ
たがいつつ	たがひつつ
たがう	たがふ
たがえ	たがへ
たがおう	たがはう
たがわざ	たがはざ
たがわず	たがはず
たがわな	たがはな
たがわぬ	たがはぬ
たがわん	たがはん
たくらもう	たくらまう
たくわえ	たくはへ
たくわえよう	たくはへよう
たぐい	たぐひ
たぐいなくて	たぐひなくて
たぐい飲み	たぐい飮み
たぐい呑み	たぐい呑み
たけなわ	たけなは
たしなもう	たしなまう
たじたじ	たぢたぢ
たじろい	たぢろい
たじろが	たぢろが
たじろぎ	たぢろぎ
たじろぐ	たぢろぐ
たじろげ	たぢろげ
たじろごう	たぢろがう
たずさえ	たづさへ
たずさわ	たづさは
たずね	たづね
たたいた	たたいた
たたいて	たたいて
たたえ	たたへ
たたえざる	たたえざる
たたえまない	たたえまない
たたえまなき	たたえまなき
たたえよう	たたへよう
ただよい	ただよひ
ただよう	ただよふ
ただようて	ただようて
ただよえば	ただよへば
ただよおう	ただよはう
ただよわ	ただよは
たちうお	たちうを
たちんぼう	たちんばう
たてついた	たてついた
たてついて	たてついて
たとうか	たたうか
たとうから	たとうから
たとうが	たたうが
たとうがたっ	たとうがたつ
たとうがん	たとうがん
たとうさん	たとうさん
たとうじゃ	たたうぢや
たとうぞ	たたうぞ
たとうちゃん	たとうちゃん
たとうでは	たたうでは
たとうと	たたうと
たとうとい	たたふとい
たとうとし	たたうとし
たとうとす	たたうとす
たとうとも	たたうとも
たとうに	たたうに
たとうね	たたうね
たとうの	たとうの
たとうのたっ	たとうのたつ
たとうふ	たとうふ
たとうよ	たたうよ
たとうようよ	たたうようよ
たとえ	たとへ
たどりついた	たどりついた
たどりついて	たどりついて
たなびいた	たなびいた
たなびいて	たなびいて
たのう	たなう
たのうさぎ	たのうさぎ
たのうのう	たのうのう
たのしもう	たのしまう
たまい	たまひ
たまいど	たまいど
たまう	たまふ
たまうら	たまうら
たまえ	たまへ
たまおう	たまはう
たましい	たましひ
たまずさ	たまづさ
たまわ	たまは
ためらい	ためらひ
ためらう	ためらふ
ためらえ	ためらへ
ためらおう	ためらはう
ためらわ	ためらは
たもう	たまう
たもういち	たもういち
たもうこんな	たもうこんな
たもうすぐ	たもうすぐ
たもうひと	たもうひと
たもうろう	たもうろう
たもう一	たもう一
たもう少	たもう少
たゆたい	たゆたひ
たゆたう	たゆたふ
たゆたえ	たゆたへ
たゆたおう	たゆたはう
たゆたわ	たゆたは
たるもう	たるまう
たろう	たらう
たわいない	たわいない
たわいなか	たわいなか
たわいなく	たわいなく
たわいなけ	たわいなけ
たわいのう	たわいなう
たわけた	たはけた
たわけて	たはけて
たわけもの	たはけもの
たわける	たはける
たわけ者	たはけ者
たわごと	たはごと
たわむれ	たはむれ
たわ言	たは言
たんじょう	たんじやう
だいず	だいづ
だいたい	だいたい
だおさ	だふさ
だおさえ	だおさへ
だおさき	だおさき
だおさすり	だおさすり
だおさない子	だをさない子
だおさなご	だをさなご
だおさな子	だをさな子
だおさむ	だおさむ
だおさら	だおさら
だおし	だふし
だおしい	だをしい
だおしえ	だおしへ
だおしお	だおしお
だおしく	だをしく
だおしどり	だをしどり
だおしべ	だをしべ
だおしぼり	だおしぼり
だおしめ	だおしめ
だおしゃ	だおしゃ
だおしゃか	だおしやか
だおしら	だおしら
だおしん	だおしん
だおす	だふす
だおすそ	だおすそ
だおすみ	だおすみ
だおすわり	だおすわり
だおせ	だふせ
だおせおせ	だおせおせ
だおせち	だおせち
だおそう	だふさう
だおれ	だふれ
だおれから	だおれから
だおれが	だおれが
だおれさま	だおれさま
だおれしか	だおれしか
だおれで	だおれで
だおれの	だおれの
だおれは	だおれは
だおれも	だおれも
だおれら	だおれら
だおれを	だおれを
だおれ様	だおれ様
だくらもう	だくらまう
だくわえ	だくはへ
ださそう	だささう
だちょう	だてう
だっきゅう	だつきう
だぶついた	だぶついた
だぶついて	だぶついて
だましい	だましひ
だみごえ	だみごゑ
だらといたって	だらとゐたつて
だろう	だらう
ちあい	ちあひ
ちいさ	ちひさ
ちいさそう	ちひささう
ちがわざ	ちがはざ
ちがわず	ちがはず
ちがわな	ちがはな
ちがわぬ	ちがはぬ
ちきしょう	ちくしやう
ちくしょう	ちくしやう
ちぢもう	ちぢまう
ちなもう	ちなまう
ちまおう	ちまはう
ちゃいろ	ちやいろ
ちゅうちょ	ちうちょ
ちょー	てう
ちょうず	てうづ
ちょうだい	ちやうだい
ちょうちょ	てふてふ
ちょうちょう	てふてふ
ちょうちん	ちやうちん
ちょうつがい	てふつがひ
ちょうど	ちやうど
ちょうな	てうな
ちょうむすび	ちょうむすび
ちょうら	ちやうら
ちょう結び	てふ結び
ちらついた	ちらついた
ちらついて	ちらついて
ちんちょうげ	ちんちやうげ
ぢょうちん	ぢやうちん
ついえざ	つひえざ
ついえず	つひえず
ついえた	つひえた
ついえて	つひえて
ついえない	つひえない
ついえなか	つひえなか
ついえなく	つひえなく
ついえなけれ	つひえなけれ
ついえぬ	つひえぬ
ついえよう	つひえよう
ついぞ	つひぞ
ついた	ついた
ついて	ついて
ついに	つひに
ついばもう	ついばまう
ついやさざ	つひやさざ
ついやさず	つひやさず
ついやさな	つひやさな
ついやさぬ	つひやさぬ
ついやさん	つひやさん
ついやし	つひやし
ついやす	つひやす
ついやすい	ついやすい
ついやすかっ	ついやすかつ
ついやすく	ついやすく
ついやせ	つひやせ
ついやせた	ついやせた
ついやせて	ついやせて
ついやそう	つひやさう
つかい	つかひ
つかう	つかふ
つかえ	つかへ
つかおう	つかはう
つかまえ	つかまへ
つかまえよう	つかまへよう
つかもう	つかまう
つかわ	つかは
つがい	つがひ
つがう	つがふ
つがえ	つがへ
つがおう	つがはう
つがわ	つがは
つきそい	つきそひ
つきそう	つきそふ
つきそうだ	つきさうだ
つきそうで	つきさうで
つきそうな	つきさうな
つきそうに	つきさうに
つきそえ	つきそへ
つきそおう	つきそはう
つきそわ	つきそは
つくつくぼうし	つくつくぼふし
つくばい	つくばひ
つくばう	つくばふ
つくばえ	つくばへ
つくばおう	つくばはう
つくばわ	つくばは
つくろい	つくろひ
つくろう	つくろふ
つくろう。	つくらう。
つくろうと	つくらうと
つくろえ	つくろへ
つくろおう	つくろはう
つくろわ	つくろは
つぐない	つぐなひ
つぐなう	うぐなふ
つぐなえ	つぐなへ
つぐなおう	つぐなはう
つぐなわ	つぐなは
つごう	つがう
つたい	つたひ
つたう	つたふ
つたえ	つたへ
つたおう	つたはう
つたわ	つたは
つちかい	つちかひ
つちかう	つちかふ
つちかえ	つちかへ
つちかおう	つちかはう
つちかわ	つちかは
つつしもう	つつしまう
つづいた	つづいた
つづいて	つづいて
つどい	つどひ
つどう	つどふ
つどえ	つどへ
つどおう	つどはう
つどわ	つどは
つなごう	つながう
つぶやいた	つぶやいた
つぶやいて	つぶやいて
つまずいた	つまづいた
つまずいて	つまづいて
つまずか	つまづか
つまずき	つまづき
つまずく	つまづく
つまずけ	つまづけ
つまずこう	つまづかう
つまづいた	つまづいた
つまづいて	つまづいて
つまづこう	つまづかう
つまもう	つままう
つまようじ	つまやうじ
つもう	つまう
つもういち	つもういち
つもうこんな	つもうこんな
つもうすぐ	つもうすぐ
つもうひと	つもうひと
つもうろう	つもうろう
つもう一	つもう一
つもう少	つもう少
つりざお	つりざを
つれそい	つれそひ
つれそう	つれそふ
つれそうだ	つれさうだ
つれそうで	つれさうで
つれそうな	つれさうな
つれそうに	つれさうに
つれそえ	つれそへ
つれそおう	つれそはう
つれそわ	つれそは
つわもの	つはもの
つわり	つはり
つわ者	つは者
つんざいた	つんざいた
つんざいて	つんざいて
づいた	づいた
づいて	づいて
づかい	づかひ
づかう	づかふ
づかえ	づかへ
づかおう	づかはう
づかもう	づかまう
づかわ	づかは
づくろい	づくろひ
づくろう	づくろふ
づくろうと	づくらうと
づくろえ	づくろへ
づくろおう	づくろはう
づくろわ	づくろは
ていず	てゐず
ていた	てゐた
ていただい	ていただい
ていただか	ていただか
ていただき	ていただき
ていただく	ていただく
ていただけず	ていただけず
ていただけた	ていただけた
ていただけて	ていただけて
ていただけぬ	ていただけぬ
ていただけま	ていただけま
ていただけよう	ていただけよう
ていただける	ていただける
ていただけれ	ていただけれ
ていただこう	ていただかう
ていて	てゐて
ていない	てゐない
ていなかっ	てゐなかつ
ていなかろう	てゐなからう
ていなく	てゐなく
ていなけれ	てゐなけれ
ていまし	てゐまし
ています	てゐます
ていませ	てゐませ
ていよう	てゐよう
ている	てゐる
ていれば	てゐれば
ており	てをり
てぐすねひいて	てぐすねひいて
てずから	てづから
てっぽー	てつぱう
てっぽう	てつぱう
てっぽうみず	てつぱうみづ
てなずけ	てなづけ
てもがいた	てもがいた
てもがいて	てもがいて
てゆー	ていふ
てらい	てらひ
てらいやつ	てらいやつ
てらい奴	てらい奴
てらう	てらふ
てらえ	てらへ
てらおう	てらはう
てらわ	てらは
てんてこまい	てんてこまひ
てんとうむし	てんたうむし
てんとう虫	てんたう蟲
でくのぼう	でくのばう
でしょう	でせう
でずっぱり	でづつぱり
でっぽう	でつぱう
でならい	でならひ
でならう	でならう
でならえ	でならえ
でまう	でまふ
とーぜん	たうぜん
といえども	といへども
とうがらし	たうがらし
とうきび	たうきび
とうきょう	とうきやう
とうことから	とふことから
とうことが	とふことが
とうことだ	とふことだ
とうことで	とふことで
とうことに	とふことに
とうことは	とふことは
とうことも	とふことも
とうぜん	たうぜん
とうてい	たうてい
とうとい	たふとい
とうといい	たふといひ
とうという	たふといふ
とうといえ	たふといへ
とうといおう	たふといはふ
とうといっ	たふといつ
とうといわ	たふといは
とうとう	たうとう
とうとうとし	とうとうとし
とうとうとす	とうとうとす
とうとかっ	たふとかつ
とうとから	たふとから
とうとかろ	たふとかろ
とうとけれ	たふとけれ
とうとし	たふとし
とうとした	とうとした
とうとしち	とうとしち
とうとして	とうとして
とうとつ	たうとつ
とうへんぼく	たうへんぼく
とうもろこし	たうもろこし
とえば	とへば
とおい親戚	とほい親戚
とおい世界	とほい世界
とおい話	とほい話
とおくて	とほくて
とおくなりに	とほくなりに
とおくにありて	とほくにありて
とおくの	とほくの
とおさざ	とほさざ
とおさず	とほさず
とおさな	とほさな
とおさぬ	とほさぬ
とおさん	とほさん
とおしが	とほしが
とおしし	とほしし
とおしす	とほしす
とおしせ	とほしせ
とおしだ	とほしだ
とおしつつ	とほしつつ
とおしつづ	とほしつづ
とおしで	とほしで
とおしな	とほしな
とおしに	とほしに
とおしの	とほしの
とおしは	とほしは
とおしま	とほしま
とおしも	とほしも
とおしを	とほしを
とおし続	とほし續
とおす	とほす
とおせ	とほせ
とおそう	とほさう
とおった	とほつた
とおっち	とほつち
とおって	とほつて
とおらざ	とほらざ
とおらず	とほらず
とおらな	とほらな
とおらぬ	とほらぬ
とおらん	とほらん
とおり、	とほり、
とおり。	とほり。
とおり「	とほり「
とおり」	とほり」
とおりが	とほりが
とおりし	とほりし
とおりす	とほりす
とおりせ	とほりせ
とおりだ	とほりだ
とおりつつ	とほりつつ
とおりつづ	とほりつづ
とおりで	とほりで
とおりな	とほりな
とおりに	とほりに
とおりの	とほりの
とおりは	とほりは
とおりま	とほりま
とおりも	とほりも
とおりを	とほりを
とおり続	とほり續
とおる	とほる
とおれず	とほれず
とおれずい	とおれずい
とおれずっ	とおれずつ
とおれない	とほれない
とおれなか	とほれなか
とおれなかなか	とおれなかなか
とおれなく	とほれなく
とおれなけれ	とほれなけれ
とおれぬ	とほれぬ
とおれば	とほれば
とおればか	とおればか
とおればっ	とおればつ
とおれよう	とほれよう
とおれん	とほれん
とおろう	とほらう
とかない	とかない
ときめいた	ときめいた
ときめいて	ときめいて
とくだわら	とくだはら
とこしえ	とこしへ
ところにいたって	ところにゐたつて
とつぜんおそい	とつぜんおそひ
ととのい	ととのひ
ととのう	ととのふ
ととのえ	ととのへ
ととのおう	ととのはう
ととのわ	ととのは
とどいた	とどいた
とどいて	とどいて
とどこお	とどこほ
とどろいた	とどろいた
とどろいて	とどろいて
となえ	となへ
となえよう	となへよう
とびうお	とびうを
とぼう	とばう
とまどい	とまどひ
とむらい	とむらひ
とむらう	とむらふ
とむらえ	とむらへ
とむらおう	とむらはう
とむらわ	とむらは
ともえ	ともゑ
ともない	ともなひ
ともない。	ともない。
ともないか	ともないか
ともないが	ともないが
ともないし	ともないし
ともないだ	ともないだ
ともないで	ともないで
ともないね	ともないね
ともないの	ともないの
ともないよ	ともないよ
ともなう	ともなふ
ともなえ	ともなへ
ともなおう	ともなはう
ともなわ	ともなは
とゆー	といふ
とゆう	といふ
とらえ	とらへ
とらえよう	とらへよう
とりあえず	とりあへず
とりまいた	とりまいた
とりまいて	とりまいて
とわざら	とはざら
とわざり	とはざり
とわざる	とはざる
とわず	とはず
とわない	とはない
とわなか	とはなか
とわなく	とはかく
とわなけれ	とはなけれ
とわぬ	とはぬ
とわん	とはん
とんじゃく	とんぢやく
どうこう	どうかう
どうどうた	どうどうた
どうどうと	だうだうと
どうのこうの	どうのかうの
どうみょうじ	だうみやうじ
どうもうだ	だうもうだ
どうもうな	だうもうな
どうもうに	だうもうに
どうもさえない	どうもさえない
どうもさえなか	どうもさえなか
どうもさえなく	どうもさえなく
どうもさえなけ	どうもさえなけ
どおい	どほい
どおいし	どおいし
どおさざ	どほさざ
どおさず	どほさず
どおさな	どほさな
どおさぬ	どほさぬ
どおさん	どほさん
どおし、	どほし、
どおしが	どほしが
どおしし	どほしし
どおしす	どほしす
どおしせ	どほしせ
どおしだ	どほしだ
どおしつつ	どほしつつ
どおしつづ	どほしつづ
どおしで	どほしで
どおしな	どほしな
どおしに	どほしに
どおしの	どほしの
どおしは	どほしは
どおしま	どほしま
どおしも	どほしも
どおしを	どほしを
どおし続	どほし續
どおす	どほす
どおせば	どほせば
どおそう	どほさう
どおっ	どほつ
どおらず	どほらず
どおらない	どほらない
どおり	どほり
どおる	どほる
どおれば	どほれば
どおろう	どほらう
どか弁	どか辨
どざえもん	どざゑもん
どじょう	どぢやう
どもえ	どもゑ
どよめいた	どよめいた
どよめいて	どよめいて
どろぼー	どろばう
どろぼう	どろばう
ないうちに	ないうちに
ないた	ないた
ないて	ないて
ないない	ないない
ないまぜ	なひまぜ
なえざら	なえざら
なえざる	なえざる
なえざれ	なえざれ
なえず	なえず
なえた	なえた
なえつつ	なえつつ
なえて	なえて
なえない	なえない
なえなか	なえなか
なえながら	なえながら
なえなけれ	なえなけれ
なえまく	なえまく
なえまし	なえまし
なえます	なえます
なえませ	なえませ
なえよう	なえよう
なえる	なえる
なえれば	なえれば
なおいま	なほいま
なおかさね	なほかさね
なおかつ	なほかつ
なおここ	なほここ
なおこの	なほこの
なおこれ	なほこれ
なおこんにち	なほこんにち
なおさ	なほさ
なおさら	なおさら
なおさら	なほさら
なおざり	なほざり
なおし	なほし
なおす	なほす
なおせ	なほせ
なおそう	なほさう
なおった	なほつた
なおっち	なほつち
なおって	なほつて
なおつけくわえ	なほつけくわへ
なおつけ加へ	なおつけ加へ
なおなお	なほなほ
なおのこと	なほのこと
なおの事	なほの事
なおひとこと	なほひとこと
なおひと言	なほひと言
なおまた	なほまた
なおも	なほも
なおもい	なおもひ
なおもかげ	なおもかげ
なおもくるし	なおもくるし
なおもしろ	なおもしろ
なおもたい	なおもたい
なおもちゃ	なおもちや
なおもって	なほもつて
なおもてむき	なおもてむき
なおもねり	なおもねり
なおもはゆ	なおもはゆ
なおもむき	なおもむき
なおもわせ	なおもはせ
なおら	なほら
なおり	なほり
なおる	なほる
なおれ	なほれ
なおろう	なほらう
なおわが	なほわが
なおわたし	なほわたし
なおわれわれ	なほわれわれ
なお以上	なほ以上
なお一	なほ一
なお我	なほ我
なお現在	なほ現在
なお更	なほ更
なお今	なほ今
なお今日	なほ今日
なお私	なほ私
なお重	なお重
なお生	なほ生
なお当	なほ當
なお付け加	なお附け加
なお本	なほ本
なかんずく	なかんづく
ながいねむり	ながいねむり
なきごえ	なきごゑ
なくおそい	なくおそひ
なこうど	なかうど
なごもう	なごまう
なさそう	なささう
なじもう	なじまう
なずな	なづな
なずらい	なずらひ
なずらう	なずらふ
なずらえ	なずらへ
なずらおう	なずらはう
なずらわ	なずらは
なぞめいた	なぞめいた
なぞめいて	なぞめいて
なぞらえ	なぞらへ
なっていなくて	なつていなくて
なついた	なついた
なついて	なついて
なにおい	なにほひ
なにおいて	なにをいて
なにわおどり	なにはをどり
なにわの	なにはの
なにわド根性	なにはド根性
なにわ経済	なには經濟
なにわ根性	なには根性
なにわ焼	なには焼
なにわ節	なには節
なにわ風	なには風
なにわ踊	なには踊
なびいた	なびいた
なびいて	なびいて
なまえ	なまへ
なまず	なまづ
なまめいた	なまめいた
なまめいて	なまめいて
なみうちぎわ	なみうちぎは
なめくじ	なめくぢ
なめずり	なめづり
なめずる	なめづる
ならえよう	ならへよう
ならおう	ならはう
ならぼう	ならばう
ならわざら	ならはざら
ならわざり	ならはざり
ならわざる	ならはざる
ならわざれ	ならはざれ
ならわず	ならはず
ならわな	ならはな
ならわぬ	ならわぬ
ならわん	ならはん
なりわい	なりはひ
なわしろ	なはしろ
なわとび	なはとび
なわのれん	なはのれん
なわばしご	なはばしご
なわばり	なはばり
なんじ	なんぢ
な臭い	な臭ひ
にあい	にあひ
にいず	にゐず
にいずれ	にいづれ
にいたがっ	にゐたがつ
にいたまう	にゐたまふ
にいたまえ	にゐたまへ
にいたまえば	にゐたまへば
にいたる	にいたる
にいたれ	にいたれ
にいつつ	にゐつつ
にいつづけ	にゐつづけ
にいづま	にひづま
にいながら	にゐながら
にいなく	にゐなく
においが	にほひが
においしか	にほひしか
においだ	にほひだ
においで	にほひで
においに	にほひに
においの	にほひの
においは	にほひは
においま	にほひま
においも	にほひも
においを	にほひを
におう	にほふ
におえず	におへず
におえた	にほへた
におえて	にほへて
におえな	におへな
におえぬ	におへぬ
におえま	におへま
におえよう	にほへよう
におえる	にほへる
におえん	にほへん
におおう	にほはう
におそい	におそひ
におり	にをり
におわ	にほは
におわれ	におはれ
にかわが	にかはが
にかわで	にかはで
にかわを	にかはを
にぎおう	にぎはう
にぎわい	にぎはい
にぎわう	にぎはう
にぎわえ	にぎはへ
にぎわおう	にぎははう
にぎわっ	にぎはつ
にぎわわ	にぎはは
にさそう	にさそふ
にしいる	にしひる
にしいれば	にしひれば
についた	についた
について	について
にならい	にならひ
にならう	にならう
にならえ	にならえ
ににない	にになひ
にになう	にになふ
にになえ	にになへ
にになおう	にになはう
にになわ	にになは
にはいっていきなり	にはひつていきなり
にはいってから	にはひつてから
にはいってしばらく	にはひつてしばらく
にはいってすぐ	にはひつてすぐ
にはいってとうとう	にはひつてとうたう
にはいってまもなく	にはひつてまもなく
にはいってもまだ	にはひつてもまだ
にはいってやっと	にはひつてやつと
にはいってようやく	にはひつてやうやく
にはいって間もなく	にはひつて間もなく
にはいらずに	にはひらずに
にはいらないうち	にはひらないうち
にはいらないでくだ	にはひらないでくだ
にはいらないでね	にはひらないでね
にはいらないでよ	にはひらないでよ
にはいらぬうち	にはひらぬうち
にはいりましょう	にはひりませう
にはいることも	にはひることも
にはいるところだ	にはひるところだ
にはいるところで	にはひるところで
にはいるとすぐ	にはひるとすぐ
にはいるとまもなく	にはひるとまもなく
にはいるとやっと	にはひるとやつと
にはいると間もなく	にはひると間もなく
にはいるや	にはひるや
にはいろう	にはひらう
にもいず	にもゐず
にょうぼう	にようばう
にわかに	にはかに
にわとり	にはとり
にんきょう	にんけふ
ぬいた	ぬいた
ぬいて	ぬいて
ぬうち	ぬうち
ぬかずか	ぬかづか
ぬかずき	ぬかづき
ぬかずく	ぬかづく
ぬかずけ	ぬかづけ
ぬかずこう	ぬかづかう
ぬかづい	ぬかづい
ぬぐい	ぬぐひ
ぬぐう	ぬぐふ
ぬぐえ	ぬぐへ
ぬぐおう	ぬぐはう
ぬぐわ	ぬぐは
ぬごう	ぬがう
ぬすもう	ぬすまう
ぬのをしいて	ぬのをしいて
ねあい	ねあひ
ねがい	ねがひ
ねがいがかない	ねがひがかなひ
ねがいはかない	ねがひはかなひ
ねがいもかない	ねがひもかなひ
ねがう	ねがふ
ねがえ	ねがへ
ねがおう	ねがはう
ねがわ	ねがは
ねぎらい	ねぎらひ
ねぎらう	ねぎらふ
ねぎらえ	ねぎらへ
ねぎらおう	ねぎらはう
ねぎらわ	ねぎらは
ねこなでごえ	ねこなでごゑ
ねたもう	ねたまう
ねばついた	ねばついた
ねばついて	ねばついて
ねらい	ねらひ
ねらう	ねらふ
ねらえ	ねらへ
ねらおう	ねらはう
ねらわ	ねらは
のあらい	のあらひ
のいたり	のいたり
のいたわりに	のいたはりに
のうず	のうづ
のうちにはいっ	のうちにはひつ
のうちにはいらない	のうちにはひらない
のうちにはいらぬ	のうちにはひらぬ
のうちにはいり	のうちにはひり
のうちにはいる	のうちにはひる
のうちにはいれ	のうちにはひれ
のうみそ	なうみそ
のえさ	のゑさ
のおっと	のをつと
のがよい	のがよい
のしあわび	のしあはび
のせい	のせゐ
のぞいた	のぞいた
のぞいて	のぞいて
のぞもう	のぞまう
のたまい	のたまひ
のたまう	のたまふ
のたまえ	のたまへ
のたまおう	のたまはう
のたまわ	のたまは
のっぺらぼう	のつぺらばう
のとおり	のとほり
のならい	のならひ
のならう	のならう
のならえ	のならえ
のにおい	のにほひ
のにおいて	のにおいて
のもう、	のまう、
のもう。	のまう。
のもうじゃ	のまうぢや
のもうではない	のまうではない
のもうと	のまうと
のもうにも	のまうにも
のもうね	のまうね
のもうのもう	のまうのまう
のもうも	のまうも
のもうよ	のまうよ
のもくずだ	のもくづだ
のもくずで	のもくづで
のもくずと	のもくづと
のもくずに	のもくづに
のりかえ	のりかへ
のりそい	のりそひ
のりそう	のりそふ
のりそうだ	のりさうだ
のりそうで	のりさうで
のりそうな	のりさうな
のりそうに	のりさうに
のりそえ	のりそへ
のりそおう	のりそはう
のりそわ	のりそは
のろい	のろひ
のろう	のろふ
のろえ	のろへ
のろおう	のろはう
のろわ	のろは
のんべえ	のんべゑ
のエサ	のヱサ
の臭い	の臭ひ
の内にはいっ	の内にはひつ
の内にはいり	の内にはひり
の内にはいれ	の内にはひれ
の内にはいろ	の内にはひら
の内にはいろう	の内にはひらう
はいあが	はひあが
はいえ	はいへ
はいず	はゐず
はいずくんか	はいづくんか
はいずくんぞ	はいづくんぞ
はいずこ	はいづこ
はいずみ	はいづみ
はいずり	はひづり
はいずれ	はいづれ
はいつくば	はひつくば
はいなく	はゐなく
はいのぼ	はひのぼ
はいまわ	はひまわ
はいるなり	はひるなり
はい回	はひ廻
はい廻	はひ廻
はい出	はひ出
はい昇	はひ昇
はい上	はひ上
はい登	はひ登
はえぎわ	はえぎは
はえとり	はへとり
はえなわ	はえなは
はえ取り	はへ取り
はおり	はおり
はおりから	はをりから
はおりひめ	はおりひめ
はおりをみて	はをりをみて
はおりを見て	はをりを見て
はからい	はからひ
はからう	はからふ
はからえ	はからへ
はからおう	はからはう
はからわ	はからは
はがいじめ	はがひじめ
はぐくもう	はぐくまう
はげもう	はげまう
はしゃごう	はしやがう
はじいた	はじいた
はじいっ	はぢいつ
はじいて	はじいて
はじいら	はぢいら
はじいり	はぢいり
はじいる	はぢいる
はじいれ	はぢいれ
はじいろう	はぢいらう
はじざる	はぢざる
はじざれ	はぢざれ
はじず	はぢず
はじた	はぢた
はじだ	はぢだ
はじて	はぢて
はじで	はぢで
はじな	はぢな
はじぬ	はぢぬ
はじの	はぢの
はじます	はぢます
はじませ	はぢませ
はじも	はぢも
はじよう	はぢよう
はじらい	はぢらひ
はじらう	はぢらふ
はじらえ	はぢらへ
はじらおう	はぢらはう
はじらわ	はぢらは
はじる	はぢる
はじれば	はぢれば
はじを	はぢを
はずかし	はづかし
はずべき	はづべき
はずべし	はづべし
はずま	はづま
はずみ	はづみ
はずむ	はづむ
はずめ	はづめ
はずもう	はづまう
はずれ	はづれ
はずん	はづん
はずんぐり	はずんぐり
はずんずん	はずんずん
はたいた	はたいた
はたいて	はたいて
はたおり	はたおり
はためいた	はためいた
はためいて	はためいて
はたらいた	はたらいた
はたらいて	はたらいて
はたんきょう	はたんきやう
はちうえ	はちうゑ
はなごえ	はなごゑ
はなしごえ	はなしごゑ
はなずもう	はなずまふ
はなみず	はなみづ
はならい	はならひ
はならう	はならう
はならえ	はならえ
はにかもう	はにかまう
はのう	はなう
ははうえ	ははうへ
はばもう	はばまう
はらい	はらひ
はらいせ	はらいせ
はらう	はらふ
はらえ	はらへ
はらおう	はらはう
はらもう	はらまう
はらわ	はらは
はらわた	はらわた
はりついた	はりついた
はりついて	はりついて
はるつげうお	はるつげうを
はんごう	はんがふ
はんちゅう	はんちう
ばあい	ばあひ
ばえず	ばへず
ばえない	ばへない
ばえなか	ばへなか
ばえなく	ばへなく
ばえなけれ	ばへなけれ
ばえます	ばへます
ばえる	ばへる
ばえれば	ばへれば
ばえろう	ばへらう
ばおり	ばおり
ばらい	ばらひ
ばらついた	ばらついた
ばらついて	ばらついて
ばらまいた	ばらまいた
ばらまいて	ばらまいて
ぱらい	ぱらひ
ぱらう	ぱらふ
ぱらえ	ぱらへ
ぱらおう	ぱらはう
ぱらわ	ぱらは
ひいた	ひいた
ひいて	ひいて
ひいらぎ	ひひらぎ
ひかえ	ひかへ
ひかえよう	ひかへよう
ひきい	ひきゐ
ひきいよう	ひきゐよう
ひきぎわ	ひきぎは
ひけぎわ	ひけぎは
ひざまず	ひざまづ
ひざまずいた	ひざまづいた
ひざまずいて	ひざまづいて
ひしめいた	ひしめいた
ひしめいて	ひしめいて
ひじょうな	ひじやうな
ひじょうに	ひじやうに
ひずもう	ひずまう
ひそもう	ひそまう
ひたい	ひたひ
ひっきょう	ひつきやう
ひっぱたいた	ひつぱたいた
ひっぱたいて	ひつぱたいて
ひでぇ臭い	ひでえ臭ひ
ひでえ臭い	ひでえ臭ひ
ひとあじ	ひとあぢ
ひとえ	ひとへ
ひとおもい	ひとおもひ
ひときわ	ひときは
ひとさら	ひとさら
ひとしお	ひとしほ
ひとすじ	ひとすぢ
ひとすぢなわ	ひとすじなは
ひとつさえない	ひとつさえない
ひとつさえなか	ひとつさえなか
ひとつさえなく	ひとつさえなく
ひとつさえなけ	ひとつさえなけ
ひとまちがお	ひとまちがほ
ひとむいて	ひとむいて
ひと皮むいた	ひとむいた
ひどい臭い	ひどい臭ひ
ひながし	ひなぐわし
ひなわ	ひなは
ひびいた	ひびいた
ひびいて	ひびいて
ひまわり	ひまはり
ひもといた	ひもといた
ひもといて	ひもといて
ひゃくようばこ	ひやくえふばこ
ひゃっぱつひゃくちゅう	ひやくぱつひやくちゆう
ひやみず	ひやみづ
ひょうきん	へうきん
ひょうし	ひやうし
ひょうたん	へうたん
ひょうひょう	へうへう
ひょうへん	へうへん
ひょうろく	へうろく
ひらめいた	ひらめいた
ひらめいて	ひらめいて
ひるがえ	ひるがへ
ひるがお	ひるがほ
ひろう	ひろふ
ひろえ	ひろへ
ひろおう	ひろはう
ひろわ	ひろは
びくついた	びくついた
びくついて	びくついて
びょーき	びやうき
びょういん	びやうゐん
びょうき	びやうき
びょうびょう	べうべう
びょうぶ	びやうぶ
びろい	びろひ
びわ	びは
びんぼう	びんぼふ
ふいた	ふいた
ふいて	ふいて
ふかいねむり	ふかいねむり
ふがいな	ふがひな
ふがいなくて	ふがひなくて
ふきのとう	ふきのたう
ふくらもう	ふくらまう
ふくろう	ふくろふ
ふくろとじ	ふくろとぢ
ふさがろう	ふさがらう
ふさわし	ふさはし
ふじいろ	ふぢいろ
ふじなみ	ふぢなみ
ふじばかま	ふぢばかま
ふじ色	ふぢ色
ふためいた	ふためいた
ふためいて	ふためいて
ふっかつ	ふつくわつ
ふつごう	ふつがふ
ふてぎわ	ふてぎは
ふとざお	ふとざを
ふとんをしいて	ふとんをしいて
ふぶいた	ふぶいた
ふぶいて	ふぶいて
ふまえ	ふまへ
ふらついた	ふらついた
ふらついて	ふらついて
ふりゅうもんじ	ふりふもんじ
ふるい、	ふるひ、
ふるいが	ふるひが
ふるいし	ふるひし
ふるいす	ふるひす
ふるいせ	ふるひせ
ふるいつつ	ふるひつつ
ふるいつづ	ふるひつづ
ふるいで	ふるひで
ふるいな	ふるひな
ふるいに	ふるひに
ふるいは	ふるひは
ふるいま	ふるひま
ふるいも	ふるひも
ふるいを	ふるひを
ふるい続	ふるひ續
ふるう	ふるふ
ふるえ	ふるへ
ふるおう	ふるはう
ふるかわ	ふるかは
ふるまい	ふるまひ
ふるまう	ふるまふ
ふるまえ	ふるまへ
ふるまおう	ふるまはう
ふるまわ	ふるまは
ふるわ	ふるは
ふわっと	ふはつと
ふわふわ	ふはふは
ふわり	ふはり
ふんわり	ふんはり
ぶあいそう	ぶあいさう
ぶしょう	ぶしやう
ぶっきらぼう	ぶつきらばう
ぶっちょう	ぶつちやう
ぶっちょうずら	ぶつちやうづら
ぶっぽうそう	ぶつぽふそう
ぶとうが	ぶたうが
ぶとうでは	ぶたうでは
ぶとうとし	ぶたうとし
ぶとうとす	ぶたうとす
ぶとうにも	ぶたうにも
ぶとうもの	ぶたうもの
ぶどう	ぶだう
ぶらついた	ぶらついた
ぶらついて	ぶらついて
ぶるい	ぶるひ
ぶんか社	ぶんくわ社
ぶんちょう	ぶんてう
ぶんぼうぐ	ぶんばうぐ
へつらい	へつらひ
へつらう	へつらふ
へつらえ	へつらへ
へつらおう	へつらはう
へつらわ	へつらは
へばりついた	へばりついた
へばりついて	へばりついて
へんとうせん	へんたうせん
べたついた	べたついた
べたついて	べたついて
べっこう	べつかふ
べとついた	べとついた
べとついて	べとついて
べらぼう	べらばう
べんきょう	べんきやう
べんしょうほう	べんしようはふ
べんとう	べんたう
ほうけ	ほうけ
ほうけよう	ほうけよう
ほうじ	ほうじ
ほうじょうえ	はうじやうゑ
ほうじ茶	はうじ茶
ほうせんか	ほうせんくわ
ほうだい	はうだい
ほうちょう	はうちやう
ほうっ	はふつ
ほうった	はふつた
ほうっち	はふつち
ほうって	はふつて
ほうほうの	はふはふの
ほうまん	ほうまん
ほうらざ	はふらざ
ほうらず	はふらず
ほうらな	はふらな
ほうらぬ	はふらぬ
ほうれんそう	はうれんさう
ほうろう	はふらう
ほおかぶり	ほほかぶり
ほおじろ	ほほじろ
ほおずえ	ほほづゑ
ほおずき	ほほづき
ほおばっ	ほほばつ
ほおばら	ほほばら
ほおばり	ほほばり
ほおばる	ほほばる
ほおばれ	ほほばれ
ほおばろう	ほほばろう
ほおひげ	ほほひげ
ほおべに	ほほべに
ほおぼね	ほほぼね
ほお紅	ほほ紅
ほお骨	ほほ骨
ほお髭	ほほ髭
ほくそえ	ほくそゑ
ほけきょう	ほけきやう
ほざいた	ほざいた
ほざいて	ほざいて
ほしがれい	ほしがれひ
ほぞのお	ほぞのを
ほたてがい	ほたてがひ
ほっきがい	ほつきがひ
ほっといた	ほつといた
ほっといて	ほつといて
ほどいた	ほどいた
ほどいて	ほどいて
ほのお	ほのほ
ほほえま	ほほゑま
ほほえみ	ほほゑみ
ほほえむ	ほほゑむ
ほほえめ	ほほゑめ
ほほえもう	ほほゑまう
ほらがい	ほらがひ
ほろぼう	ほろばう
ほろよい	ほろよひ
ほんだわら	ほんだはら
ほんとう	ほんたう
ほんもう	ほんまう
ほんりょう	ほんりやう
ぼうえんきょう	ばうゑんきやう
ぼうき	ばうき
ぼうさん	ばうさん
ぼうず	ばうず
ぼうぜん	ばうぜん
ぼうたおし	ばうたふし
ぼうだいだ	ばうだいだ
ぼうだいで	ばうだいで
ぼうだいな	ばうだいな
ぼうだいに	ばうだいに
ぼうだち	ばうだち
ぼうだの	ばうだの
ぼうだら	ばうだら
ぼうちょう	ばうちやう
ぼうばく	ばうばく
ぼうびき	ばうびき
ぼうや	ばうや
ぼうよう	ばうやう
ぼう立ち	ばう立ち
ぼくじゅう	ぼくじう
ぼっくい	ぼつくひ
ぼっしゅう	ぼつしう
ぼもう	ぼまう
ぼやい	ぼやい
ぼんのう	ぼんなう
まいあが	まひあが
まいこま	まひこま
まいこみ	まひこみ
まいこむ	まひこむ
まいこめば	まひこめば
まいこもう	まひこまう
まいこん	まひこん
まいごに	まひごに
まいごの	まひごの
まいった	まゐつた
まいっち	まゐつち
まいって	まゐつて
まいつつ	まひつつ
まいつづ	まひつづ
まいひめ	まひひめ
まいまい	まひまひ
まいまし	まひまし
まいましょう	まひませう
まいます	まひます
まいませ	まひませ
まいもどっ	まひもどつ
まいもどら	まひもどら
まいもどり	まひもどり
まいもどる	まひもどる
まいもどれ	まひもどれ
まいもどろう	まひもどらう
まいらざ	まいらざ
まいらず	まゐらず
まいらない	まゐらない
まいらなか	まゐらなか
まいらなく	まゐらなく
まいらなけれ	まゐらなけれ
まいらぬ	まゐらぬ
まいらん	まゐらん
まいり	まゐり
まいる	まゐる
まいれ	まゐれ
まいろう	まゐろう
まいを	まひを
まい続	まひ續
まえがき	まへがき
まえばらい	まへばらひ
まえもって	まへもつて
まおうと	まはうと
まかない	まかなひ
まかなう	まかなふ
まかなえ	まかなへ
まかなおう	まかなはう
まかなわ	まかなは
まがいから	まがひから
まがいが	まがひが
まがいだ	まがひだ
まがいで	まがひで
まがいと	まがひと
まがいない	まがひない
まがいなか	まがひなか
まがいなき	まがひなき
まがいなく	まがひなく
まがいに	まがひに
まがいの	まがひの
まがいは	まがひは
まがいまで	まがひまで
まがいも	まがひも
まがいもの	まがひもの
まがいもを	まがいもを
まがいを	まがひを
まがいモノ	まがひモノ
まがい物	まがひ物
まがえば	まがへば
まがおう	まがはう
まがわ	まがは
まぎらわ	まぎらは
まぎわ	まぎは
まごついた	まごついた
まごついて	まごついて
まじえ	まじへ
まじええ	まじええ
まじない	まじなひ
まじなう	まじなふ
まじなえ	まじなへ
まじなおう	まじなはう
まじなわ	まじなは
まじらい	まじらひ
まじらう	まじらふ
まじらえ	まじらへ
まじらおう	まじらはう
まじらわ	まじらは
まじわっ	まじはつ
まじわら	まじはら
まじわり	まじはり
まじわる	まじはる
まじわれ	まじはれ
まじわろ	まじはろ
ますます弁ず	ますます辨ず
ますらお	ますらを
まずした	まずした
まずして	まずして
まずに	まずに
またごう	またがう
またたいた	またたいた
またたいて	またたいて
まちがい	まちがひ
まちがう	まちがふ
まちがえ	まちがへ
まちがおう	まちがはう
まちがわ	まちがは
まっさお	まつさを
まっしょうめん	まつしやうめん
まっとう	まつたう
まつわり	まつはり
まつわりついた	まつはりついた
まつわりついて	まつはりついて
まつわる	まつはる
まつわれ	まつはれ
まつわれわれ	まつわれわれ
まつわろう	まつはらう
までいたって	までゐたつて
までもいたって	までもゐたつて
まとい、	まとひ、
まといだ	まとひだ
まといつつ	まとひつつ
まといつづ	まとひつづ
まといで	まとひで
まといな	まとひな
まといに	まとひに
まといは	まとひは
まといまし	まとひまし
まといます	まとひます
まといませ	まとひませ
まといを	まとひを
まとい続	まとひ續
まとう	まとふ
まとうが	またうが
まとうじゃ	まとうぢや
まとうでは	またうでは
まとうとし	またうとし
まとうとしばらく	まとふとしばらく
まとうとす	またうとす
まとうとすぐ	まとふとすぐ
まとうにも	またうにも
まとうね	またうね
まとうや	またうや
まとうよ	またうよ
まとえば	まとへば
まとおう	まとはう
まとわ	まとは
まどい	まどひ
まどう	まどふ
まどえ	まどへ
まどおう	まどはう
まどろまず	まどろまず
まどろもう	まどろまう
まどわ	まどは
まどわく	まどわく
まなぼう	まなばう
まねいた	まねいた
まねいて	まねいて
まばゆい	まばゆい
まほうが	まはふが
まほうつかい	まはふつかひ
まほうで	まはふで
まほうに	まはふに
まほうを	まはふを
ままず	ままず
まよい	まよひ
まよう	まよふ
まよえ	まよへ
まよおう	まよはう
まよわ	まよは
まるがお	まるがほ
まるぼうず	まるばうず
まわし	まはし
まわず	まはず
まわっ	まはつ
まわない	まはない
まわなか	まはなか
まわなく	まはなく
まわなけれ	まはなけれ
まわぬ	まはぬ
まわら	まはら
まわり	まはり
まわる	まはる
まわれ	まはれ
まわろう	まはらう
まんが	まんぐわ
まんがち	まんがち
まんじゅう	まんぢゆう
まんまえ	まんまへ
まんよう	まんえふ
みあい	みあひ
みえすいた	みえすいた
みえすいて	みえすいて
みおさめ	みをさめ
みおつくし	みをつくし
みがいた	みがいた
みがいて	みがいて
みぎわ	みぎは
みさお	みさを
みさかい	みさかひ
みじかいねむり	みじかいねむり
みじん	みぢん
みすえ	みすゑ
みすえよう	みすゑよう
みずあさぎ	みづあさぎ
みずあめ	みづあめ
みずいらず	みづいらず
みずうみ	みづうみ
みずおち	みづおち
みずかき	みづかき
みずから	みづから
みずがめ	みづがめ
みずきり	みづきり
みずぎわ	みづぎは
みずく	みづく
みずくさ	みづくさ
みずぐすり	みづぐすり
みずけむり	みづけむり
みずごころ	みづごころ
みずさし	みづさし
みずすまし	みづすまし
みずたき	みづたき
みずたま	みづたま
みずっぱな	みづつぱな
みずっぽ	みづつぽ
みずでっぽう	みづでつぱう
みずとあぶら	みづとあぶら
みずな	みづな
みずのあわ	みづのあわ
みずのえ	みづのえ
みずのと	みづのと
みずばしょう	みづばせう
みずばしら	みづばしら
みずばな	みづばな
みずひき	みづひき
みずびたし	みづびたし
みずぶくれ	みづぶくれ
みずぶとり	みづぶとり
みずぼうそう	みづばうさう
みずみず	みづみづ
みずむし	みづむし
みずようかん	みづやうかん
みず虫	みづ虫
みそじだ	みそぢだ
みそじで	みそぢで
みそじな	みそぢな
みそじに	みそぢに
みそじの	みそぢの
みそなわ	みそなは
みちしお	みちしほ
みとおさ	みとほさ
みとおし	みとほし
みとおす	みとほす
みとおせ	みとほせ
みとおそう	みとほさ
みのうえ	みのうへ
みみずく	みみづく
みょうが	みゃうが
みょうじ	みやうじ
みょうだ	めうだ
みょうちきりん	めうちきりん
みょうで	めうで
みょうな	めうな
みょうに	めうに
みょうにち	みやうにち
みょうばん	みょうばん
みようによつて	みやうによつて
むいた	むいた
むいて	むいて
むかい	むかひ
むかう	むかふ
むかえ	むかへ
むかおう	むかはう
むかついた	むかついた
むかついて	むかついて
むかわ	むかは
むくう	むくふ
むくえ	むくへ
むくおう	むくはう
むくまず	むくまず
むくわ	むくは
むこう	むかう
むこうがわ	むかうがは
むこうみずな	むかうみずな
むさそう	むささう
むしばまず	むしばまず
むしばもう	むしばまう
むすぼう	むすばう
むずか	むづか
むぞうさ	むざうさ
むてっぽう	むてつぱう
むゆうびょう	むいうびやう
むらおさ	むらをさ
むろあじ	むろあぢ
めいた	めいた
めいて	めいて
めおと	めをと
めぐまず	めぐまず
めずら	めづら
めだとうが	めだたうが
めだとうじゃ	めだたうぢや
めだとうでは	めだたうでは
めだとうと	めだたうと
めだとうに	めだたうに
めだとうもの	めだたうもの
めだとうよ	めだたうよ
めっそう	めつさう
めっぽう	めつぽふ
めでとう	めでたう
めばえ	めばえ
めまいがお	めまひがお
めまいがし	めまひがし
めまいがす	めまひがす
めまいがひ	めまひがひ
めまいが起	めまひが起
めまいが襲	めまひが襲
めまいだ	めまひだ
めまいで	めまひで
めまいな	めまひな
めまいの	めまひの
めまいは	めまひは
めまいも	めまひも
めまいを	めまひを
めまひまで	めまひまで
めんくらい	めんくらひ
めんくらう	めんくらふ
めんどう	めんだう
めんよう	めんよう
め立とう	め立たう
もーれつ	まうれつ
もいなく	もゐなく
もうかっ	まうかつ
もうからざ	まうからざ
もうからず	まうからず
もうからな	まうからな
もうからぬ	まうからぬ
もうからん	まうからん
もうかり	まうかり
もうかる	まうかる
もうかれば	まうかれば
もうかろう	まうからう
もうけ	まうけ
もうせ、	まうせ、
もうせ。	まうせ。
もうせば	まうせば
もうで	まうで
もうれつ、	まうれつ、
もうれつ。	まうれつ。
もうれつ！	まうれつ！
もうれつだ	まうれつだ
もうれつで	まうれつで
もうれつな	まうれつな
もうれつに	まうれつに
もうろくお	まうろくお
もうろくし	まうろくし
もうろくじ	まうろくじ
もうろくす	まうろくす
もうろくば	まうろくば
もうろくオ	まうろくヲ
もうろくジ	まうろくジ
もうろくバ	まうろくバ
もうろく婆	まうろく婆
もうろく爺	まうろく爺
もう少し	もう少し
もう然	まう然
もう全て	もう全て
もくろもう	もくろまう
もごう	もがう
もじった	もぢつた
もじって	もぢつて
もじもじ	もぢもぢ
もじらざ	もぢらざ
もじらず	もぢらず
もじらな	もぢらな
もじらぬ	もぢらぬ
もじり	もぢり
もじる	もぢる
もじれば	もぢれば
もじろう	もぢらう
もたついた	もたついた
もたついて	もたついて
もちい、	もちゐ、
もちいず	もちゐず
もちいた	もちゐた
もちいつ	もちゐつ
もちいて	もちゐて
もちいな	もちゐな
もちいぬ	もちゐぬ
もちいま	もちゐま
もちいよ	もちゐよ
もちいる	もちゐる
もちいれ	もちゐれ
もちいろ	もちゐろ
もちまえ	もちまへ
もったいなくて	もつたいなくて
もついばまず	もついばまず
もとい	もとゐ
もといて	もといて
もとう。	もたう。
もとうか	もたうか
もとうが	もたうが
もとうじゃ	もたうぢや
もとうでは	もたうでは
もとうとし	もたうとし
もとうとす	もたうとす
もとうにも	もたうにも
もとうね	もたうね
もとうもの	もたうもの
もとうよ	もたうよ
もならい	もならひ
もならう	もならう
もならえ	もならえ
ものおじ	ものおぢ
ものをしいて	ものをしいて
もみじ	もみぢ
もやい	もやひ
もよう	もやう
もよおさ	もよほさ
もよおし	もよほし
もよおす	もよほす
もよおせ	もよほせ
もよおそう	もよほさう
もらい	もらひ
もらう	もらふ
もらえ	もらへ
もらおう	もらはう
もらわ	もらは
もりじお	もりじほ
もんしろちょう	もんしろてふ
やいた	やいた
やいて	やいて
やえざくら	やへざくら
やおちょう	やほちやう
やおや	やほや
やおよろず	やほよろづ
やおら	やをら
やかん	やくわん
やしない	やしなひ
やしなう	やしなふ
やしなえ	やしなへ
やしなおう	やしなはう
やしなわ	やしなは
やしもう	やしまう
やじうま	やぢうま
やじがとび	やじがとび
やじが飛	やじが飛
やじろべえ	やじろべゑ
やじをとば	やじをとば
やじを飛	やじを飛
やじ馬	やぢ馬
やすらい	やすらひ
やすらう	やすらふ
やすらえ	やすらへ
やすらおう	やすらはう
やすらわ	やすらは
やっかい	やくかい
やっきだ	やくきだ
やっきで	やくきで
やっきな	やくきな
やっきに	やくきに
やっきの	やくきの
やっきょう	やくけふ
やとい	やとひ
やといい	やといひ
やという	やといふ
やといえ	やといへ
やといおう	やといはう
やといっ	やといつ
やといわ	やといは
やとう	やとふ
やとえ	やとへ
やとおう	やとはう
やとわ	やとは
やとわた	やとわた
やにわに	やにはに
やまい	やまひ
やまず	やまず
やもう	やまう
やよい	やよひ
やろう	やらう
やわじゃ	やはぢや
やわだ	やはだ
やわで	やはで
やわな	やはな
やわなが	やわなが
やわなで	やわなで
やわなに	やわなに
やわなの	やわなの
やわなので	やはなので
やわなは	やわなは
やわなを	やわなを
やわはだ	やははだ
やわらいじゃ	やはらいぢや
やわらいだ	やはらいだ
やわらいで	やはらいで
やわらか	やはらか
やわらが	やはらが
やわらぎ	やはらぎ
やわらぐ	やはらぐ
やわらげ	やはらげ
やわらごう	やはらごう
やわらちゃん	やはらちやん
やんわり	やんはり
ゆいいつ	ゆいいつ
ゆいのう	ゆひなふ
ゆううつ	いううつ
ゆうがお	ゆふがほ
ゆうがた	ゆふがた
ゆうぎり	ゆふぎり
ゆうぐれ	ゆふぐれ
ゆうげ	ゆふげ
ゆうげしき	ゆふげしき
ゆうごはん	ゆふごはん
ゆうしお	ゆふしほ
ゆうじゅうふだん	いうじうふだん
ゆうすずみ	ゆふすずみ
ゆうする	いうする
ゆうずう	ゆうづう
ゆうぞら	ゆふぞら
ゆうだち	ゆふだち
ゆうづくよ	ゆふづくよ
ゆうなぎ	ゆふなぎ
ゆうに	いうに
ゆうにこと	いふにこと
ゆうはん	ゆふはん
ゆうひ	ゆふひ
ゆうびん	いうびん
ゆうべ	ゆふべ
ゆうめし	ゆふめし
ゆうもや	ゆふもや
ゆうやけ	ゆふやけ
ゆうやみ	ゆふやみ
ゆうゆう	いういう
ゆうれい	いうれい
ゆえ	ゆゑ
ゆかいだ	ゆくわいだ
ゆかいで	ゆくわいで
ゆかいな	ゆくわいな
ゆかいに	ゆくわいに
ゆがまず	ゆがまず
ゆがもう	ゆがまう
ゆきわりそう	ゆきわりさう
ゆくえ	ゆくへ
ゆずっ	ゆづつ
ゆずら	ゆづら
ゆずり	ゆづり
ゆずる	ゆづる
ゆずれ	ゆづれ
ゆずろう	ゆづらう
ゆびずもう	ゆびずまふ
ゆまず	ゆまず
ゆみず	ゆみづ
ゆめがかない	ゆめがかなひ
ゆめはかない	ゆめはかなひ
ゆめもかない	ゆめもかなひ
ゆらめいた	ゆらめいた
ゆらめいて	ゆらめいて
ゆるごう	ゆるがう
ゆるもう	ゆるまう
ゆわ	ゆは
ゆわえ	ゆはへ
よいごこち	よひごこち
よいごし	よひごし
よいざまし	よひざまし
よいざめ	よひざめ
よいしれ	よひしれ
よいつぶ	よひつぶ
よいどれ	よひどれ
よいのくち	よひのくち
よいのみ	よひのみ
よいの口	よひの口
よいの明星	よひの明星
よいやみ	よひやみ
よいやみば	よいやみば
ようかい人間	えうくわい人間
ようこそ	ようこそ
ようじん	ようじん
ようする	ようする
ようするに	えうするに
ようちえん	えうちえん
ようちだ	えうちだ
ようちな	えうちな
ようとしてしれ	えうとしてしれ
ようとしてゆくえ	えうとしてゆくえ
ようとして行方	えうとして行方
ようとして知れ	えうとして知れ
ようとして不	えうとして不
ようやく	やうやく
ようやっと	やうやつと
ようろう	やうらう
ようろういん	やうらうゐん
よう音	やう音
よう来	よう來
よこたわ	よこたは
よこちょう	よこちやう
よさそう	よさそう
よしわら	よしはら
よじ	よぢ
よそえ	よそへ
よそおい	よそほひ
よそおう	よそほふ
よそおえ	よそほへ
よそおおう	よそほはう
よそおわ	よそほは
よたろう	よたらう
よつんばい	よつんばひ
よのう	よなう
よばわり	よばはり
よびごえ	よびごゑ
よぼう	よばう
よまいごと	よまひごと
よまず	よまず
よりそい	よりそひ
よりそう	よりそふ
よりそうだ	よりさうだ
よりそうで	よりさうで
よりそうな	よりさうな
よりそうに	よりさうに
よりそえ	よりそへ
よりそおう	よりそはう
よりそわ	よりそは
よろこぼう	よろこばう
よろず	よろづ
よろめいた	よろめいた
よろめいて	よろめいて
よわいを	よはひを
らえる	らへる
らごう	らがう
らそう	らそふ
らそうだ	らさうだ
らそうで	らさうで
らそうな	らさうな
らそうに	らさうに
らっかせい	らくくわせい
らっきょ	らつきよう
らっきょう	らつきよう
らまず	らまず
らわれ	らはれ
らんおう	らんわう
りあい	りあひ
りもがいた	りもがいた
りもがいて	りもがいて
りゅう	りう
りゅうおう	りゆうおう
りゅうぐう	りゆうぐう
りゅうず	りゆうづ
りゅうりゅう	りゆうりゆう
りょう	りやう
りょうかい	れうかい
りょうきん	れうきん
りょうけん	れうけん
りょうじゅう	れふじゆう
りょうぜん	れうぜん
りょうり	れうり
ることもない	ることもない
るにいた	るにいた
るまず	るまず
れあい	れあひ
れもう	れまう
ろあい	ろあひ
ろうけつぞめ	らうけつぞめ
ろうけつ染	らうけつ染
ろうぜき	ろうぜき
ろうそく	らふそく
ろうぞめ	らふぞめ
ろうたけた	らうたけた
ろうたけて	らうたけて
ろうたける	らうたける
ろうなぬし	らうなぬし
ろうにゃく	らうにやく
ろうにんぎょう	らふにんぎやう
ろうばいし	らうばいし
ろうばいす	らうばいす
ろうばいを	らうばいを
ろうびき	らふびき
ろう細工	らふ細工
ろう人形	らふ人形
ろくじぞう	ろくじざう
ろごう	ろがう
わいた	わいた
わいて	わいて
わかがえ	わかがへ
わかしお	わかしほ
わきまえ	わきまへ
わきみず	わきみづ
わぐまず	わぐまず
わけまえ	わけまへ
わざおぎ	わざをぎ
わずか	わづか
わずらい	わづらひ
わずらう	わづらふ
わずらえ	わづらへ
わずらおう	わづらはう
わずらっ	わづらつ
わずらわ	わづらは
わたがし	わたぐわし
わたせせいぞう	わたせせいざう
わなないた	わなないた
わなないて	わなないて
わびずまい	わびずまひ
わまず	わまず
わめいた	わめいた
わめいて	わめいて
わらい	わらひ
わらいがお	わらひがほ
わらいごえ	わらひごゑ
わらいじょうご	わらひじやうご
わらう	わらふ
わらえ	わらへ
わらおう	わらはう
わらじ	わらぢ
わらぼうし	わらぼふし
わらわざ	わらはざ
わらわず	わらはず
わらわな	わらはな
わらわぬ	わらはぬ
わらわん	わらはん
わりあい	わりあひ
わるぢえ	わるぢゑ
をあまず	をあまず
をいただいた	をいただいた
をいただいて	をいただいて
をいため	をいため
をいとなまず	をいとなまず
をえさ	をゑさ
をおおい	をおほひ
をおしまざ	ををしまざ
をおしまず	ををしまず
をおしまぬ	ををしまぬ
をおしまん	ををしまん
をおそい	をおそひ
をかくする	をくわくする
をからめず	をからめず
をきそう	をきそふ
をくらい	をくらひ
をこのまず	をこのまず
をこばまず	をこばまず
をさげすまず	をさげすまず
をさげずまず	をさげずまず
をさそう	をさそふ
をしいる	をしひる
をしいれば	をしひれば
をじゃ	をぢや
をたくらまず	をたくらまず
をたしなまず	をたしなまず
をたたまず	をたたまず
をたのまず	をたのまず
をついばまず	をついばまず
をつぐまず	をつぐまず
をつつまず	をつつまず
をなう	をなふ
をなえ	をなへ
をなおう	をなはう
をなつかしまず	をなつかしまず
をならい	をならひ
をならう	をならう
をならえ	をならえ
をなわ	をなは
をにない	をになひ
をになう	をになふ
をになえ	をになへ
をになおう	をになはう
をになわ	をになは
をぬすまず	をぬすまず
をねたまず	をねたまず
をのぞまず	をのぞまず
をのまず	をのまず
をはいた	をはいた
をはいて	をはいて
をはさまず	をはさまず
をふくまず	をふくまず
をふまず	をふまず
をまう	をまふ
をやすまず	をやすまず
をエサ	をヱサ
んじまい	んぢまひ
んじまう	んぢまふ
んじまえ	んぢまへ
んじまおう	んぢまはう
んじまっ	んぢまつ
んじまわ	んぢまは
んじゃ	んぢや
んじゃい	んぢやひ
んじゃう	んぢやふ
んじゃうじゃ	んぢやふじや
んじゃえ	んぢやへ
んじゅう	んぢゆう
んじよう	んじよう
んじようがあ	んじやうがあ
んじようがな	んじやうがな
んじようは	んじやうは
んじようも	んじやうも
んたろう	んたらう
アイガモ	アヒガモ
アオガイ	アヲガヒ
アオガエル	アヲガヘル
アオキ	アヲキ
アオダイショウ	アヲダイシヤウ
アオバエ	アヲバヘ
アオミズ	アヲミヅ
アオムシ	アヲムシ
アオリ	アフリ
アカエイ	アカエヒ
アカガイ	アカガヒ
アカダイ	アカダヒ
アゲハチョウ	アゲハテフ
アコウ	アカヲ
アコウダイ	アカヲダヒ
アコヤガイ	アコヤガヒ
アサガオ	アサガホ
アジア	アジヤ
アジサイ	アヂサヰ
アジシオ	アヂシホ
アズキ	アヅキ
アホウドリ	アハウドリ
アホウ鳥	アハウ鳥
アマダイ	アマダヒ
アメンボウ	アメンバウ
アライグマ	アラヒグマ
アリガトウ	アリガタウ
アルジェリア	アルゼリヤ
アワダチソウ	アワダチサウ
アワビ	アハビ
アンコウ	アンカウ
イイダコ	イヒダコ
イエバエ	イヘバエ
イシモチソウ	イシモチサウ
イジケ	イヂケ
イジメ	イヂメ
イチロウ	イチラウ
イツロウ	イツラウ
イデオロギー	イデオロギイ
イトウオ	イトウヲ
イナズマ	イナヅマ
イノウエ	イノウヘ
イノシシ	ヰノシシ
イボガエル	イボガヘル
イモリ	ヰモリ
イワナ	イハナ
インディア	インヂア
インネン	インエン
インパクト	イムパクト
インペリアル	イムペリアル
ウイキョウ	ウイキヤウ
ウイロウ	ウイラウ
ウオノメ	ウヲノメ
ウガイ	ウガヒ
ウグイ	ウグヒ
ウグイス	ウグヒス
ウシオ	ウシホ
ウシガエル	ウシガヘル
ウズラ	ウヅラ
ウタロウ	ウタラウ
ウマバエ	ウマバヘ
ウラジミール	ウラヂーミル
ウワサ	ウハサ
ウワバミ	ウハバミ
エーション	エイション
エイク	エイク
エイコ	エイコ
エイジ	エイヂ
エイズ	エイズ
エイゼン	エイゼン
エイト	エイト
エイド	エイド
エイリアン	エイリヤン
エクボ	ヱクボ
エグい	ヱグい
エグか	ヱグか
エグく	ヱグく
エグけれ	ヱグけれ
エグイ	ヱグイ
エグミ	ヱグミ
エサが	ヱサが
エサだ	ヱサだ
エサで	ヱサで
エサと	ヱサと
エサなみ	ヱサなみ
エサに	ヱサに
エサの	ヱサの
エサも	ヱサも
エサを	ヱサを
エジキ	ヱジキ
エネルギー	エネルギイ
エビス	ヱビス
エンゲージ	エンゲイヂ
エンジニア	エンヂニア
エンジン	エンヂン
エンドウ	ヱンドウ
オウム	アウム
オウム真理	オウム眞理
オカムラ	ヲカムラ
オカモチ	ヲカモチ
オカモト	ヲカモト
オガタマノキ	ヲガタマノキ
オギワラ	ヲギハラ
オグラ	ヲグラ
オケラ	ヲケラ
オコゼ	ヲコゼ
オコワ	オコハ
オサム	ヲサム
オシドリ	ヲシドリ
オシベ	ヲシベ
オズオズ	オヅオヅ
オタケビ	ヲタケビ
オトコ	ヲトコ
オトメ	ヲトメ
オトリ	ヲトリ
オバケ	オバケ
オバナ	ヲバナ
オヒレ	ヲヒレ
オビレ	ヲビレ
オマエ	オマヘ
オロチ	ヲロチ
オンナ	ヲンナ
カイコ	カヒコ
カイソウ	カイサウ
カイチュウ	クワイチユウ
カイヨウ	クワイヤウ
カイライ	クワイライ
カイワレ	カヒワレ
カエデ	カヘデ
カエル	カヘル
カゲロウ	カゲロフ
カシワ	カシハ
カジキ	カヂキ
カスガイ	カスガヒ
カスミソウ	カスミサウ
カズラ	カヅラ
カッコ	クワツコ
カッコいい	カツカウいい
カッコし	カツカウし
カッコす	カツカウす
カッコせ	カツカウせ
カッコつけ	カツカウつけ
カッコよい	カツカウよい
カッコよか	カツカウよか
カッコよく	カツカウよく
カッコよけ	カツカウよけ
カッコイー	カツカウイイ
カッコイイ	カツカウイイ
カッコ良	カツカウ良
カツオ	カツヲ
カツヤク筋	クワツヤク筋
カノジョ	カノヂヨ
カバー	カヴァー
カムフラージュ	カムフラーヂュ
カラスガイ	カラスガヒ
カリントウ	クワリンタウ
カレー	カリー
カレイ	カレヒ
カワイイ	カハイイ
カワウソ	カハウソ
カワセミ	カハセミ
カンキリ	クワンキリ
カンゾウ	クワンザウ
カンヅメ	クワンヅメ
カンヌキ	クワンヌキ
カンピョウ	カンペウ
カンペキ	クワンペキ
カン詰め	クワン詰め
カン切り	クワン切り
カ月	箇月
カ国	箇國
カ所	箇所
カ条	箇條
カ年	箇年
ガイジン	グワイジン
ガエル	ガヘル
ガシワ	ガシハ
ガチョウ	ガテウ
ガツオ	ガツヲ
ガビョウ	グワビヤウ
ガレージ	ガレーヂ
ガレイ	ガレヒ
ガンコ	グワンコ
キキョウ	キキヤウ
キチロウ	キチラウ
キュウカンチョウ	キウクワンテウ
キュウリ	キウリ
キョウチクトウ	ケフチクタウ
キライ	キラヒ
キルケゴール	キェルケゴール
キンバエ	キンバヘ
キンメダイ	キンメダヒ
ギンバエ	ギンバヘ
クイーン	クヰーン
クジラ	クヂラ
クロダイ	クロダヒ
クワイ	クワヰ
ケーション	ケイション
ケジメ	ケヂメ
ケ月	箇月
ケ国	箇國
ケ所	箇所
ケ条	箇條
ケ年	箇年
ゲーション	ゲイション
ゲジゲジ	ゲヂゲヂ
コウノトリ	コフノトリ
コウモリ	カウモリ
コオロギ	コホロギ
コショウ	コセウ
コチョウラン	コテフラン
コンジット	コンヂット
コンパス	コムパス
ゴシック	ゴチック
ゴボウ	ゴバウ
ゴロウ	ゴラウ
ゴワついた	ゴワついた
ゴワついて	ゴワついて
サクラソウ	サクラサウ
サザンカ	サザンクワ
サファイア	サハイヤ
サファイヤ	サハイヤ
サブロウ	サブラウ
サヤエンドウ	サヤヱンドウ
サンショウ	サンセウ
サンショウウオ	サンセウウヲ
サンディエゴ	サンディゴ
シイタケ	シヒタケ
シェルブール	セルブール
シジュウカラ	シジフカラ
シソチョウ	シソテウ
シチメンチョウ	シチメンテウ
シチロウ	シチラウ
シティー	シテー
シマダイ	シマダヒ
シミズ	シミヅ
シメジ	シメヂ
ショー	ショウ
ショーペンハウエル	ショオペンハウエル
ショウガ	シヤウガ
ショウジョウ	シヤウジヤウ
ショウユ	シヤウユ
シラウオ	シラウヲ
シロウ	シラウ
シロウト	シロウト
ジウム	ヂウム
ジゴク	ヂゴク
ジジ	ヂヂ
ジャイロ	ヂヤイロ
ジャケット	ヂャケツ
ジャコウ	ジヤカウ
ジュージュー	ヂウヂウ
ジュウシマツ	ジフシマツ
ジュウジュウ	ヂウヂウ
ジュウロウ	ジフラウ
ジュラルミン	ヂュラルミン
ジョーク	ヂョーク
ジレンマ	ディレムマ
ジロウ	ジラウ
ジロウ	ヂロウ
ジンチョウゲ	ヂンチヤウゲ
スイカ	スイクワ
スイッチ	スヰッチ
スズキ	スズキ
スター	スタア
ステージ	ステーヂ
スティール	スチール
スティテュー	スチチュー
ストーブ	ストーヴ
ズーズー弁	ズーズー辯
ズボン	ヅボン
セーカツ	セイクワツ
セイカツ	セイクワツ
セレナーデ	セレナード
ゼーション	ゼイション
ソビエト	ソヴィエート
ソメイヨシノ	ソメヰヨシノ
ソルトレーク	ソルトレーキ
ソヴィエト	ソヴィエート
ゾウリ	ザウリ
タケロウ	タケラウ
タジタジ	タヂタヂ
タチウオ	タチウヲ
タロウ	タラウ
ダーウィン	ダーウヰン
ダイジョウブ	ダイヂヤウブ
ダイズ	ダイヅ
ダチョウ	ダテウ
ダンパー	ダムパー
チアイ	チアヒ
チガイ	チガヒ
チャージャー	チャーヂャー
チョー	チヤウ
チョーク	チョーク
チョーサー	チョーサー
チョーネンテン	チャウネンテン
チョー捻転	チャウ捻轉
チョウジ	チヤウジ
チョウジャ	チヤウジヤ
チョウセン	テウセン
チョウチョウ	テフテフ
チョウチン	チヤウチン
チョウツガイ	テフツガヒ
チョウナ	テウナ
チョウ詰め	チヤウ詰め
ツキミソウ	ツキミサウ
ツクツクボウシ	ツクツクボフシ
ツルカメソウ	ツルカメサウ
ツワブキ	ツハブキ
ツワモノ	ツハモノ
ツワリ	ツハリ
テーション	テイション
ティティ	チチー
ティティー	チチー
テッポー	テツパウ
テッポウ	テツパウ
テネシー	テンネッシー
テライが	テラヒが
テライの	テラヒの
テライを	テラヒを
テントウムシ	テンタウムシ
テントウ虫	テンタウ蟲
デーション	デイション
ディーゼル	デイゼル
ディケンス	ディッケンス
トウガラシ	タウガラシ
トウキビ	タウキビ
トウモロコシ	タウモロコシ
トケイソウ	トケイサウ
トゲウオ	トゲウヲ
トビウオ	トビウヲ
トリニダート	トリニダット
ドジョウ	ドジヤウ
ドストエフスキー	ドストイエフスキイ
ドラえもん	ドラゑもん
ドロボー	ドロバウ
ドロボウ	ドロバウ
ナイジェリア	ナイゼリア
ナズナ	ナヅナ
ナマズ	ナマヅ
ナメクジ	ナメクヂ
ニーチェ	ニイチェ
ニオい	ニホひ
ニオう	ニホふ
ニオっ	ニホつ
ニオわ	ニホは
ニオイ	ニホヒ
ニカワ	ニカハ
ニチニチソウ	ニチニチサウ
ニワトリ	ニハトリ
ネーション	ネイション
ネライ	ネラヒ
ノコギリソウ	ノコギリサウ
ノルマンディー	ノルマンデー
ハイデガー	ハイデッガー
ハズカ	ハヅカ
ハズレ	ハヅレ
ハチロウ	ハチラウ
ハンカチ	ハンケチ
バーミンガム	バーミングハム
バイオリン	ヴィオロン
パーセント	パセント
パライ	パラヒ
ヒイラギ	ヒヒラギ
ヒマワリ	ヒマハリ
ヒューマニティー	ヒューマニチー
ヒョウ柄	ヘウ柄
ビョーキ	ビヤウキ
ビンボー	ビンボフ
ビンボウ	ビンボフ
ピストル一丁	ピストル一挺
ピストル九丁	ピストル九挺
ピストル五丁	ピストル五挺
ピストル三丁	ピストル三挺
ピストル四丁	ピストル四挺
ピストル七丁	ピストル七挺
ピストル数丁	ピストル數挺
ピストル二丁	ピストル二挺
ピストル八丁	ピストル八挺
ピストル六丁	ピストル六挺
フーバー	フーヴァー
フィリピン	フィリッピン
フィルム	フヰルム
フキノトウ	フキノタウ
フクロウ	フクロフ
フジ	フヂ
フルトベングラー	フルトヴヱングラー
フローベル	フロオベル
フワっ	フハつ
フワッ	フハッ
フワフワ	フハフハ
フワリ	フハリ
フンワリ	フンハリ
ブドウ	ブダウ
ブリッジ	ブリッヂ
プレー	プレイ
プロペラ	プロペラー
ヘリウム	ヘリューム
ヘントウ	ヘンタウ
ベーション	ベイション
ベッコウ	ベツカフ
ベテラン	ヴェテラン
ベネゼエラ	ベネズエラ
ベラボー	ベラバウ
ベラボウ	ベラバウ
ベランダ	ヴェランダ
ベルサイユ	ヴェルサイユ
ペーション	ペイション
ページ	ペイジ
ホーケイ	ハウケイ
ホータイ	ハウタイ
ホーチョウ	ハウチヤウ
ホーレンソウ	ハウレンサウ
ホーロー	ハフラウ
ホウキ	ハウキ
ホウセンカ	ホウセンクワ
ホウタイ	ハウタイ
ホウチョウ	ハウチヤウ
ホウレンソウ	ハウレンサウ
ホウロウ	ハフラウ
ホオジロ	ホホジロ
ホタテガイ	ホタテガヒ
ホッカイドウ	ホクカイダウ
ホッキガイ	ホツキガヒ
ホッキョク	ホクキヨク
ホラガイ	ホラガヒ
ボーゼン	バウゼン
ボウズ	バウズ
ボウダラ	バウダラ
マイマイ	マヒマヒ
マゴイ	マゴヒ
マジナイ	マジナヒ
マズい	マヅい
マズう	マヅう
マズか	マヅか
マズく	マヅく
マズけれ	マヅけれ
マズイ	マヅイ
マダイ	マダヒ
マッコウクジラ	マツカウクヂラ
マテガイ	マテガヒ
マネジ	マネジ
マリッジ	マリエッヂ
マンガ	マングワ
マンガン	マンガン
マンジュウ	マンヂユウ
ミカンソウ	ミカンサウ
ミズスマシ	ミヅスマシ
ミズドリ	ミヅドリ
ミズバショウ	ミヅバセウ
ミミズク	ミミヅク
ミョウガ	ミヤウガ
ミョウバン	ミヤウバン
ミルガイ	ミルガヒ
メーション	メイション
メール	メイル
モーツァルト	モオツァルト
モーパッサン	モオパッサン
モウレツ	マウレツ
モウロク	マウロク
モジモジ	モヂモヂ
モジリ	モヂリ
モミジ	モミヂ
モンシロチョウ	モンシロテフ
ヤカン	ヤクワン
ヤコウガイ	ヤクワウガヒ
ヤコウチュウ	ヤクワウチユウ
ヤジが飛	ヤヂが飛
ヤジを飛	ヤヂを飛
ヤジロベエ	ヤジロベヱ
ヤッキョウ	ヤクケフ
ユーレイ	イウレイ
ユウウツ	イウウツ
ユウガオ	ユフガホ
ユウレイ	イウレイ
ヨウ酸	エフ酸
ヨウ素	エフ素
ライチョウ	ライテウ
ライプチヒ	ライプチッヒ
ラジオ	ラヂオ
ラファエル	ラファヱル
ランプ	ラムプ
ランボー	ランボオ
リュウズ	リュウヅ
ルフトハンザ	ルフト・ハンザ
レーション	レイション
レイチョウ	レイテウ
レイチョウ類	レイチヤウ類
レインボー	レインボウ
レンゲソウ	レンゲサウ
レンジファインダー	レンヂファインダー
ロールスロイス	ロールス・ロイス
ロウびき	ラフびき
ロウゼキ	ラフゼキ
ロウソク	ラフソク
ロウ引き	ラフ引き
ロウ細工	ラフ細工
ロウ人形	ラフ人形
ロウ染	ラフ染
ロケ弁	ロケ辨
ロサンジェルス	ロス・エンゼルス
ロサンゼルス	ロス・エンゼルス
ワズライ	ワヅラヒ
ワラジ	ワラヂ
ワレモコウ	ワレモカウ
ンタロウ	ンタラウ
ヵ月	箇月
ヵ国	箇國
ヵ所	箇所
ヵ条	箇條
ヵ年	箇年
ヶ月	箇月
ヶ国	箇國
ヶ所	箇所
ヶ条	箇條
ヶ年	箇年
亜	亞
哀しまず	哀しまず
哀しもう	哀しまう
愛おし	愛ほし
愛唱	愛誦
逢い	逢ひ
逢う	逢ふ
逢え	逢へ
逢おう	逢はう
逢わ	逢は
悪	惡
悪い臭い	惡い臭ひ
芦	蘆
鯵	鰺
圧	壓
扱い	扱ひ
扱う	扱ふ
扱え	扱へ
扱おう	扱はう
扱わ	扱は
宛い	宛ひ
宛いただ	宛いただ
宛いますぐ	宛いますぐ
宛う	宛ふ
宛え	宛へ
宛おう	宛はう
宛がい	宛がひ
宛がいい	宛がいい
宛がいっぱい	宛がいつぱい
宛がいつも	宛がいつも
宛がいま	宛がいま
宛がいまし	宛がひまし
宛がいます	宛がひます
宛がいませ	宛がひませ
宛がう	宛がふ
宛がえ	宛がへ
宛がおう	宛がはう
宛がわ	宛がは
宛わ	宛は
安らい	安らひ
安らう	安らふ
安らえ	安らへ
安らおう	安らはう
安らわ	安らは
安逸	安佚
安全弁	安全瓣
暗々裏	暗々裡
暗がり	闇がり
暗影	暗翳
暗記	諳記
暗黒	闇黒
暗唱	諳誦
暗然	黯然
暗鈍	闇鈍
暗箱	暗函
暗夜	闇夜
暗夜行路	暗夜行路
案のじょう	案のぢよう
案配	按配
案配布	按配布
案分	按分
囲	圍
囲い	圍ひ
囲いい	圍いい
囲いたさ	圍いたさ
囲いたした	圍いたした
囲いたして	圍いたして
囲いたしま	圍いたしま
囲いたす	圍いたす
囲いたせ	圍いたせ
囲いただい	圍いただい
囲いただか	圍いただか
囲いただき	圍いただき
囲いただく	圍いただく
囲いただけ	圍いただけ
囲いただこう	圍いただかう
囲いちめん	圍いちめん
囲いっぱい	圍いつぱい
囲う	圍ふ
囲え	圍へ
囲お	圍は
囲まず	圍まず
囲もう	圍まう
囲わ	圍は
委縮	萎縮
意気ようよう	意氣やうやう
意気軒高	意氣軒昂
意気消沈	意氣銷沈
意向	意嚮
意向上	意向上
慰謝	慰藉
為	爲
移ろい	移ろひ
移ろう	移ろふ
移ろうと	移らうと
移ろえ	移ろへ
移ろおう	移ろはう
移ろわ	移ろは
胃かいよう	胃くわいよう
萎まず	萎まず
萎もう	萎まう
衣装	衣裳
謂い	謂ひ
謂う	謂ふ
謂え	謂へ
謂おう	謂はう
謂わ	謂は
違い	違ひ
違いたさず	違いたさず
違いたさな	違いたさな
違いたさぬ	違いたさぬ
違いたした	違いたした
違いたして	違いたして
違いたす	違いたす
違いたせ	違いたせ
違いたそう	違いたさう
違いなくて	違ひなくて
違う	違ふ
違え	違へ
違おう	違はう
違わ	違は
遺跡	遺蹟
医	醫
育とう。	育たう。
育とうか	育たうか
育とうが	育たうが
育とうじゃ	育たうじゃ
育とうで	育たうで
育とうと	育たうと
育とうに	育たうに
育とうね	育たうね
育とうよ	育たうよ
育まず	育まず
育もう	育まう
一画	一劃
一画家	一畫家
一獲千金	一攫千金
一騎打ち	一騎討ち
一個	一箇
一個人	一個人
一族ろうとう	一族らうたう
一族ろうどう	一族らうだう
一番	一番
一皮むいた	一皮むいた
一皮むいて	一皮むいて
一編	一篇
一編集	一編輯
壱	壹
逸楽	佚楽
逸書	佚書
逸文	佚文
稲	稻
引いた	引いた
引いて	引いて
引きぎわ	引きぎは
引き上げ者	引揚げ者
引っかいた	引つかいた
引っかいて	引つかいて
引用者注	引用者註
引用注	引用註
飲	飮
飲まず	飮まず
飲もう	飮まう
淫逸	淫佚
陰影	陰翳
隠	隱
隠滅	湮滅
羽ばたいた	羽ばたいた
羽ばたいて	羽ばたいて
雨もよう	雨もやう
雨もようふ	雨もようふ
雨もよう降	雨もよう降
窺い	窺ひ
窺う	窺ふ
窺え	窺へ
窺おう	窺はう
窺わ	窺は
唄い	唄ひ
唄いろいろ	唄いろいろ
唄う	唄ふ
唄うた	唄うた
唄え	唄へ
唄おう	唄はう
唄わ	唄は
欝	鬱
厩	廏
閏	閠
云い	云ひ
云う	云ふ
云え	云へ
云おう	云はう
云わ	云わ
運ぼう	運ばう
営	營
営まず	營まず
営もう	營まう
曳	曵
曳いた	曵いた
曳いて	曵いて
栄	榮
永いねむり	永いねむり
永らえ	永らへ
泳ごう	泳がう
英才	穎才
英知	叡智
衛	衞
詠まず	詠まず
詠もう	詠まう
詠嘆	詠歎
駅	驛
駅弁	驛辨
悦ぼう	悦ばう
厭い	厭ひ
厭いや	厭いや
厭う	厭ふ
厭え	厭へ
厭おう	厭はう
厭わ	厭は
円	圓
延々といたって	延々とゐたつて
怨まず	怨まず
怨もう	怨まう
援護	掩護
沿い	沿ひ
沿う	沿ふ
沿え	沿へ
沿おう	沿はう
沿わ	沿は
炎心	焔心
煙	烟
艶	艷
艶めいた	艷めいた
艶めいて	艷めいて
遠のいた	遠のいた
遠のいて	遠のいて
遠退いた	遠退いた
遠退いて	遠退いて
塩	鹽
於いた	於いた
於いて	於いて
汚らわし	汚らはし
凹もう	凹まう
奥	奧
応	應
応え	應へ
押さえ	押さへ
押さえがき	押さへがき
押しずもう	押しずまふ
横あい	横あひ
横じく	横ぢく
横たえ	横たへ
横たお	横たふ
横たわ	横たは
欧	歐
殴	毆
鴬	鶯
黄ばまず	黄ばまず
黄ばもう	黄ばまう
沖あい	沖あひ
憶説	臆説
憶測	臆測
憶病	臆病
恩義	恩誼
穏	穩
下にしいた	下にしいた
下にしいて	下にしいて
下克上	下剋上
下張	下貼
仮	假
何個	何箇
価	價
加え	加へ
加わ	加は
加勢	加勢
夏めいた	夏めいた
夏めいて	夏めいて
嫁ごう	嫁がう
歌い	歌ひ
歌いい	歌いい
歌いくら	歌いくら
歌いっぱい	歌いつぱい
歌いろいろ	歌いろいろ
歌う	歌ふ
歌うた	歌うた
歌うまいじゃ	歌うまいぢや
歌うまいで	歌うまいで
歌うまいね	歌うまいね
歌うまいの	歌うまいの
歌うまいよ	歌うまいよ
歌うまいん	歌うまいん
歌うまか	歌うまか
歌うまかろう	歌うまからう
歌うまく	歌うまく
歌うまけれ	歌うまけれ
歌え	歌へ
歌おう	歌はう
歌ごえ	歌ごゑ
歌わ	歌は
火炎	火焔
稼ごう	稼がう
花弁	花瓣
苛もう	苛まう
霞まず	霞まず
霞もう	霞まう
画	畫
画さ	劃さ
画さえ	畫さへ
画し	劃し
画す	劃す
画すべて	畫すべて
画せ	劃せ
画そう	劃さう
画一主義	劃一主義
画一的	劃一的
画期的	劃期的
画賛	畫讚
画時代的	劃時代的
画然	劃然
画断	劃斷
画定	劃定
餓え	餓ゑ
会	會
会い	會ひ
会いか	會いか
会いき	會いき
会いく	會いく
会いけ	會いけ
会いこう	會いかう
会いたさず	會いたさず
会いたさな	會いたさな
会いたさぬ	會いたさぬ
会いたした	會いたした
会いたして	會いたして
会いたしま	會いたしま
会いたす	會いたす
会いたせ	會いたせ
会いたそう	會いたさう
会いただい	會いただい
会いただか	會いただか
会いただき	會いただき
会いただく	會いただく
会いただけ	會いただけ
会いただこう	會いただかう
会いちばん	會いちばん
会いっ	會いつ
会いつだ	會いつだ
会いつで	會いつで
会いや	會いや
会いろいろ	會いろいろ
会う	會ふ
会え	會へ
会おう	會はう
会わ	會は
解いた	解いた
解いて	解いて
回	囘
回さ	廻さ
回さえ	囘さへ
回し	廻し
回す	廻す
回する	囘する
回すれ	囘すれ
回せ	廻せ
回せよ	囘せよ
回そう	廻さう
回り	廻り
回航	廻航
回旋	廻旋
回船	廻船
回漕	廻漕
回送	廻送
回虫	蛔蟲
回転	廻轉
回復	恢復
回文	廻文
回覧	廻覽
回廊	廻廊
壊	壞
壊れ	毀れ
壊滅	潰滅
壊乱	潰亂
壊裂	潰裂
快活	快濶
快弁	快辯
怪しまず	怪しまず
怪しもう	怪しまう
懐	懷
懐いた	懷いた
懐いて	懷いて
懐かしまず	懐かしまず
懐かしもう	懷かしまう
戒告	誡告
海食	海蝕
皆既食	皆既蝕
絵	繪
開いた	開いた
開いて	開いて
開削	開鑿
開知	開智
外郭	外廓
外注	外註
外注意	外注意
外注目	外注目
外堀	外濠
咳いた	咳いた
咳いて	咳いて
害い	害ひ
害いたさ	害いたさ
害いたし	害いたし
害いたす	害いたす
害いたせ	害いたせ
害いたそう	害いたさう
害いたそうと	害いたさうと
害う	害ふ
害え	害へ
害おう	害はう
害わ	害は
慨嘆	慨歎
碍	礙
蛎	蠣
鈎	鉤
拡	擴
撹	攪
格好	恰好
格好き	格好き
格闘	挌鬪
格幅	恰幅
殻	殼
覚	覺
郭大	廓大
革張り	革貼り
学	學
学ぼう	學ばう
岳	嶽
楽	樂
楽しもう	樂しまう
額ずいた	額づいた
額ずいて	額づいて
額ずか	額づか
額ずき	額づき
額ずく	額づく
額ずけ	額づけ
額ずこう	額づこう
割いた	割いた
割いて	割いて
割注	割註
活気づいた	活氣づいた
活気づいて	活氣づいて
活発	活溌
活弁	活辯
渇いた	渇いた
渇いて	渇いて
叶い	叶ひ
叶う	叶ふ
叶え	叶へ
叶おう	叶はう
叶わ	叶は
竃	竈
蒲団をしいた	蒲團をしいた
蒲団をしいて	蒲團をしいて
噛まず	噛まず
噛もう	噛まう
粥	鬻
乾いた	乾いた
乾いて	乾いて
乾留	乾溜
勘弁	勘辨
勧	勸
巻	卷
巻いた	卷いた
巻いて	卷いて
喚いた	喚いた
喚いて	喚いて
堪え	堪へ
干害	旱害
干天	旱天
患い	患ひ
患いたさ	患いたさ
患いっ	患いつ
患う	患ふ
患え	患へ
患おう	患はう
患わ	患は
感づいた	感づいた
感づいて	感づいて
感嘆	感歎
慣わ	慣は
憾まず	憾まず
換え	換へ
換わ	換は
敢え	敢へ
歓	歡
歓ぼう	歡ばう
汗ばまず	汗ばまず
汗みずく	汗みづく
潅	灌
緩まず	緩まず
緩もう	緩まう
缶	罐
肝心	肝腎
肝入り	肝煎り
観	觀
諌	諫
貫いた	貫いた
貫いて	貫いて
貫録	貫禄
間欠性	間歇性
間欠泉	間歇泉
間欠的	間歇的
間欠熱	間歇熱
関	關
関わ	關は
関数	函數
関西弁	關西辯
関連	關聯
陥	陷
陥没	陷沒
丸ぼうず	丸ばうず
含まず	含まず
含もう	含まう
巌	巖
顔	顏
顔面そうはく	顏面さうはく
願い	願ひ
願いがかない	願ひがかなひ
願いたさ	願いたさ
願いたした	願いたした
願いたして	願いたして
願いたしま	願いたしま
願いたす	願いたす
願いたせ	願いたせ
願いたそうと	願いたさうと
願いただい	願いただい
願いただか	願いただか
願いただき	願いただき
願いただく	願いただく
願いただけ	願いただけ
願いただこう	願いただかう
願いはかない	願ひはかなひ
願いもかない	願ひもかなひ
願う	願ふ
願え	願へ
願おう	願はう
願わ	願は
企まず	企まず
企もう	企まう
企画	企劃
喜々として	嬉々として
喜ぼう	喜ばう
器	噐
基いた	基いた
基いて	基いて
基づいた	基づいた
基づいて	基づいて
奇	竒
奇形	畸形
奇人	畸人
奇跡	竒蹟
奇想曲	綺想曲
奇談	綺談
奇知	竒智
奇弁	詭辯
奇譚	綺譚
寄りそい	寄りそひ
寄りそう	寄りそふ
寄りそうだ	寄りさうだ
寄りそうで	寄りさうで
寄りそうな	寄りさうな
寄りそうに	寄りさうに
寄りそえ	寄りそへ
寄りそおう	寄りそはう
寄りそわ	寄りそは
寄りついた	寄りついた
寄りついて	寄りついて
希い	希ひ
希う	希ふ
希え	希へ
希おう	希はう
希わ	希は
希ガス	稀ガス
希塩	稀鹽
希元素	稀元素
希釈	稀釋
希少	稀少
希代	稀代
希薄	稀薄
希有金属	稀有金属
希硫酸	稀硫酸
忌まず	忌まず
期年	朞年
棄損	毀損
機械体操	噐械體操
機知	機智
帰	歸
気	氣
気づいた	氣づいた
気づいて	氣づいて
気ばまず	氣ばまず
気炎	氣焔
気色ばもう	氣色ばまう
気迫	氣魄
気付いた	氣附いた
気付いて	氣附いて
記章	徽章
貴ぼう	貴ばう
起とう。	起たう。
起とうか	起たうか
起とうが	起たうが
起とうじゃ	起たうぢや
起とうで	起たうで
起とうと	起たうと
起とうに	起たうに
起とうね	起たうね
起とうや	起たうや
輝いた	輝いた
輝いて	輝いて
飢え	饑ゑ
飢餓	饑餓
飢饉	饑饉
鬼がわら	鬼がはら
鬼気迫	鬼氣迫
亀	龜
偽	僞
戯	戲
技量	技倆
欺いた	欺いた
欺いて	欺いて
犠	犧
疑い	疑ひ
疑いたさ	疑いたさ
疑いたし	疑いたし
疑いたす	疑いたす
疑いたせ	疑いたせ
疑いたそうが	疑いたさうが
疑いたそうと	疑いたさうと
疑いただい	疑いただい
疑いただか	疑いただか
疑いただき	疑いただき
疑いただく	疑いただく
疑いただけ	疑いただけ
疑いただこう	疑いただかう
疑いっぱい	疑いつぱい
疑う	疑ふ
疑え	疑へ
疑おう	疑はう
疑わ	疑は
義援	義捐
掬い	掬ひ
掬う	掬ふ
掬え	掬へ
掬おう	掬はう
掬わ	掬は
喫驚	吃驚
喫緊	吃緊
喫水	吃水
詰まず	詰まず
脚注	脚註
逆らい	逆らひ
逆らう	逆らふ
逆らえ	逆らへ
逆らおう	逆らはう
逆らわ	逆らは
逆止め弁	逆止め瓣
逆止弁	逆止瓣
逆波	逆浪
休まず	休まず
休らい	休らひ
休らう	休らふ
休らえ	休らへ
休らおう	休らはう
休らわ	休らは
及ぼう	及ばう
吸い	吸ひ
吸いたさ	吸いたさ
吸いたして	吸いたして
吸いたしま	吸いたしま
吸いたす	吸いたす
吸いたせ	吸いたせ
吸いたそうが	吸いたさうが
吸いたそうと	吸いたさうと
吸う	吸ふ
吸え	吸へ
吸おう	吸はう
吸わ	吸は
吸入弁	吸入瓣
急いた	急いた
急いて	急いて
急ごう	急がう
救い	救ひ
救う	救ふ
救え	救へ
救おう	救はう
救わ	救は
汲まず	汲まず
汲もう	汲まう
泣いた	泣いた
泣いて	泣いて
泣きごえ	泣きごゑ
泣きついた	泣きついた
泣きついて	泣きついて
糾い	糾ひ
糾いたさ	糾いたさ
糾いたし	糾いたし
糾いたす	糾いたす
糾いたせ	糾いたせ
糾いたそうが	糾いたさうが
糾いたそうと	糾いたさうと
糾う	糾ふ
糾え	糾へ
糾おう	糾はう
糾わ	糾は
糾弾	糺彈
糾明	糺明
給い	給ひ
給いくら	給いくら
給いたさ	給いたさ
給いたした	給いたした
給いたして	給いたして
給いたしま	給いたしま
給いたす	給いたす
給いたせ	給いたせ
給いたそう	給いたさう
給いっぱい	給いつぱい
給う	給ふ
給え	給へ
給おう	給はう
給わ	給は
旧	舊
旧跡	舊蹟
拒まず	拒まず
拒もう	拒まう
拠	據
拠金	醵金
拠出	醵出
挙	擧
漁労	漁撈
魚労	漁撈
供え	供へ
供宴	饗宴
供応	饗應
競い	競ひ
競う	競ふ
競え	競へ
競おう	競はう
競わ	競は
凶悪	兇惡
凶漢	兇漢
凶器	兇噐
凶行	兇行
凶手	兇手
凶刃	兇刃
凶変	兇變
凶暴	兇暴
叫ぼう	叫ばう
峡	峽
強いた	強ひた
強いたさ	強いたさ
強いたし	強いたし
強いたす	強いたす
強いたせ	強いたせ
強いたそう	強いたさう
強いただい	強いただい
強いただか	強いただか
強いただき	強いただき
強いただく	強いただく
強いただけ	強いただけ
強いただこう	強いただかう
強いたつまき	強いたつまき
強いたつ巻	強いたつ巻
強いたぬき	強いたぬき
強いたまねぎ	強いたまねぎ
強いため	強いため
強いためんどう	強ひためんだう
強いて	強ひて
強いてぬぐい	強いてぬぐい
強いよう	強ひよう
強いようす	強いやうす
強いようだ	強いやうだ
強いようで	強いやうで
強いような	強いやうな
強いように	強いやうに
強いる	強ひる
強いれば	強ひれば
強固	鞏固
強弁	強辯
恐々	兢々
恐山のいたこ	恐山のいたこ
挟	挾
挟まず	挾まず
挟もう	挾まう
教え	教へ
教わ	教は
教戒	教誨
橋頭保	橋頭堡
狂い	狂ひ
狂いたさ	狂いたさ
狂いたした	狂いたした
狂いたして	狂いたして
狂いたしま	狂いたしま
狂いたす	狂いたす
狂いたせ	狂いたせ
狂いたそうが	狂いたさうが
狂いたそうと	狂いたさうと
狂う	狂ふ
狂え	狂へ
狂おう	狂はう
狂おし	狂ほし
狂わ	狂は
狭	狹
興奮	昂奮
響いた	響いた
響いて	響いて
驚いた	驚いた
驚いて	驚いて
驚嘆	驚歎
尭	敍
暁	曉
玉弁	玉瓣
勤しまず	勤しまず
勤しもう	勤しまう
均整	均齊
禁固	禁錮
謹まず	謹まず
謹もう	謹まう
近づいた	近づいた
近づいて	近づいて
吟唱	吟誦
九個	九箇
九州弁	九州辯
区	區
区画	區劃
苦しまず	苦しまず
苦しもう	苦しまう
駆	驅
駆けずっ	驅けづつ
駆けずら	驅けづら
駆けずり	驅けづり
駆けずる	驅けづる
駆けずれ	驅けづれ
駆けずろう	驅けづらう
具え	具へ
具わ	具は
具合	工合
愚図ついた	愚圖ついた
愚図ついて	愚圖ついて
愚知	愚智
喰い	喰ひ
喰いたした	喰いたした
喰いたして	喰いたして
喰いたしま	喰いたしま
喰いたす	喰いたす
喰いたせ	喰いたせ
喰いたそうと	喰いたそうと	
喰う	喰ふ
喰え	喰へ
喰おう	喰はう
喰らい	喰らひ
喰らう	喰らふ
喰らえ	喰らへ
喰らおう	喰らはう
喰らわ	喰らは
喰わ	喰は
空いた	空いた
空いて	空いて
空回	空回
空もよう	空もやう
屈まず	屈まず
屈もう	屈まう
掘削	掘鑿
窪まず	窪まず
窪もう	窪まう
勲	勳
薫蒸	燻蒸
薫製	燻製
訓戒	訓誡
訓注	訓註
係わ	係は
係船	繋船
係争	繋争
係属	繋属
係留	繋留
傾いた	傾いた
傾いて	傾いて
径	徑
恵	惠
恵まず	惠まず
慶ぼう	慶ばう
憩い	憩ひ
憩いくら	憩いくら
憩いたさ	憩いたさ
憩いたし	憩いたし
憩いたす	憩いたす
憩いたせ	憩いたせ
憩いたそう	憩いたさう
憩いただい	憩いただい
憩いただか	憩いただか
憩いただき	憩いただき
憩いただく	憩いただく
憩いただけ	憩いただけ
憩いただこう	憩いただかう
憩いっ	憩いつ
憩う	憩ふ
憩え	憩へ
憩おう	憩はう
憩わ	憩は
携い	携ひ
携う	携ふ
携え	携へ
携おう	携はう
携わ	携は
敬い	敬ひ
敬いたさな	敬いたさな
敬いたさぬ	敬いたさぬ
敬いたした	敬いたした
敬いたして	敬いたして
敬いたしま	敬いたしま
敬いたす	敬いたす
敬いたせ	敬いたせ
敬いたそう	敬いたさう
敬う	敬ふ
敬え	敬へ
敬おう	敬はう
敬わ	敬は
渓	溪
経	經
経とう。	經たう。
経とうか	經たうか
経とうが	經たうが
経とうと	經たうと
経とうに	經たうに
継	繼
継い	繼い
継ごう	繼がう
繋ごう	繋がう
茎	莖
蛍	螢
計らい	計らひ
計らう	計らふ
計らえ	計らへ
計らおう	計らはう
計らわ	計らは
計画	計畫
計算機	計算器
軽	輕
頚	頸
鶏	鷄
芸	藝
迎え	迎へ
撃とう、	撃たう、
撃とう。	撃たう。
撃とうか	撃たうか
撃とうが	撃たうが
撃とうじゃ	撃たうぢや
撃とうぞ	撃たうぞ
撃とうで	撃たうで
撃とうと	撃たうと
撃とうに	撃たうに
撃とうね	撃たうね
撃とうよ	撃たうよ
激高	激昂
激臭	劇臭
激職	劇職
激震	劇震
激甚	劇甚
激痛	劇痛
激変	劇變
激務	劇務
欠	缺
欠いた	缺いた
欠いて	缺いて
欠伸	欠伸
決壊	決潰
決起	蹶起
決然	蹶然
決別	訣別
結い	結ひ
結いたさ	結いたさ
結いたし	結いたし
結いたす	結いたす
結いたせ	結いたせ
結いたそう	結いたさう
結いただか	結いただか
結いただき	結いただき
結いただく	結いただく
結いただけ	結いただけ
結う	結ふ
結え	結へ
結お	結は
結びついた	結びついた
結びついて	結びついて
結ぼう	結ばう
結わ	結は
結わえ	結はへ
月決め	月極め
月食	月蝕
倹	儉
倦まず	倦まず
券	劵
剣	劍
喧騒	喧噪
圏	圈
嫌い	嫌ひ
嫌う	嫌ふ
嫌え	嫌へ
嫌おう	嫌はう
嫌わ	嫌は
建とう。	建たう。
建とうか	建たうか
建とうが	建たうが
建とうと	建たうと
建とうに	建たうに
建とうもの	建たうもの
懸河の弁	懸河の辯
捲いた	捲いた
捲いて	捲いて
検	檢
権	權
牽いた	牽いた
牽いて	牽いて
献	獻
研ごう	研がう
研摩	研磨
県	縣
見おさめ	見をさめ
見さかい	見さかひ
見とおさ	見とほさ
見とおし	見とほし
見とおす	見とほす
見とおせ	見とほせ
見とおそう	見とほさう
見まがう	見まがふ
遣い	遣ひ
遣う	遣ふ
遣え	遣へ
遣おう	遣はう
遣わ	遣は
険	險
険阻	嶮岨
顕	顯
顕わ	顕は
験	驗
元凶	元兇
原注	原註
厳	嚴
厳ついぞ	嚴ついぞ
厳然	儼然
弦歌	絃歌
弦楽	絃樂
弦管	絃管
弦線	絃線
減圧弁	減壓瓣
現わ	現は
言い	云ひ
言いおいた	云ひおいた
言いおいて	云ひおいて
言いくら	言いくら
言いたさず	言いたさず
言いたさな	言いたさな
言いたさぬ	言いたさぬ
言いたした	言いたした
言いたして	言いたして
言いたしま	言いたしま
言いたす	言いたす
言いたせ	言いたせ
言いただい	言いただい
言いただか	言いただか
言いただき	言いただき
言いただく	言いただく
言いただけ	言いただけ
言いただこう	言いただかう
言いっぱい	言いつぱい
言いついた	云ひついた
言いついて	云ひついて
言いろいろ	言いろいろ
言い継いた	云ひ繼いた
言い継いて	云ひ繼いて
言い置いた	云ひ置いた
言い置いて	云ひ置いて
言う	云ふ
言うこともない	云ふこともない
言え	云へ
言えましょう	云へませう
言おう	云はう
言っ	云つ
言わ	云は
個所	箇所
個条	箇条
個数	箇數
個別	箇別
古希	古稀
古跡	古蹟
古注	古註
呼ばわり	呼ばはり
呼びごえ	呼びごゑ
呼ぼう	呼ばう
故知	故智
枯渇	涸渇
跨ごう	跨がう
雇い	雇ひ
雇いきなり	雇いきなり
雇いくら	雇いくら
雇いたさ	雇いたさ
雇いたした	雇いたした
雇いたして	雇いたして
雇いたしま	雇いたしま
雇いたす	雇いたす
雇いたせ	雇いたせ
雇いたそうと	雇いたさうと
雇いちばん	雇いちばん
雇いっぱい	雇いつぱい
雇いろいろ	雇いろいろ
雇う	雇ふ
雇え	雇へ
雇おう	雇はう
雇わ	雇は
雇用	雇傭
五個	五箇
五編	五篇
五編集	五編輯
五弁	五瓣
後ろ盾	後ろ楯
後盾	後楯
後編	後篇
後編集	後編輯
御者	馭者
語らい	語らひ
語らう	語らふ
語らえ	語らへ
語らおう	語らはう
語らわ	語らは
乞い	乞ひ
乞う	乞ふ
乞え	乞へ
乞おう	乞はう
乞わ	乞は
交い	交ひ
交いかに	交いかに
交いたさ	交いたさ
交いたしま	交いたしま
交いたす	交いたす
交いたせ	交いたせ
交いたそう	交いたさう
交う	交ふ
交え	交へ
交おう	交はう
交らい	交らひ
交らう	交らふ
交らえ	交らへ
交らおう	交らはう
交らわ	交らは
交わ	交は
交歓	交驩
交差	交叉
効	效
効いた	效いた
効いて	效いて
口ずさまず	口ずさまず
向かい	向かひ
向かう	向かふ
向かえ	向かへ
向かおう	向かはう
向かわ	向かは
向こう	向かう
向こうみず	向かうみず
好いた	好いた
好いて	好いて
好まず	好まず
好もう	好まう
巧知	巧智
幸い	幸ひ
幸いっぱい	幸いつぱい
幸いつまで	幸いつまで
広	廣
広壮	宏壯
広大	宏大
広島弁	廣島辯
広範	廣汎
広報	弘報
広野	曠野
恒	恆
抗い	抗ひ
抗いくら	抗いくら
抗いたさず	抗いたさず
抗いたさぬ	抗いたさぬ
抗いたし	抗いたし
抗いたす	抗いたす
抗いたせ	抗いたせ
抗いたそう	抗いたさう
抗う	抗ふ
抗え	抗へ
抗おう	抗はう
抗わ	抗は
抗弁	抗辯
拘わ	拘は
控え	控へ
控除	扣除
攻めあぐまず	攻めあぐまず
更生	甦生
校注	校註
構い	構ひ
構う	構ふ
構え	構へ
構おう	構はう
構わ	構は
江戸弁	江戸辯
紅炎	紅焔
耕運機	耕耘機
考え	考へ
考えついた	考へついた
考えついて	考へついて
肯い	肯ひ
肯う	肯ふ
肯え	肯へ
肯おう	肯はう
肯わ	肯は
荒れもよう	荒れもやう
行い	行ひ
行いくら	行いくら
行いたさ	行いたさ
行いたした	行いたした
行いたして	行いたして
行いたしま	行いたしま
行いたす	行いたす
行いたせ	行いたせ
行いたそうが	行いたさうが
行いたそうと	行いたさうと
行いただいた	行いただいた
行いただいて	行いただいて
行いただか	行いただか
行いただき	行いただき
行いただく	行いただく
行いただけ	行いただけ
行いただこう	行いただかう
行いちばん	行いちばん
行いっぱい	行いつぱい
行いろいろ	行いろいろ
行う	行ふ
行え	行へ
行おう	行はう
行ない	行なひ
行ないし	行ないし
行なう	行なふ
行なえ	行なへ
行なおう	行なはう
行なわ	行なは
行わ	行は
講和	媾和
貢ごう	貢がう
購い	贖ひ
購う	贖ふ
購え	贖へ
購おう	贖はう
購わ	贖は
鉱	鑛
鉱業	礦業
鉱石	礦石
砿	礦
香典	香奠
高根の花	高嶺の花
高進	亢進
高騰	昂騰
高波	高浪
高揚	昂揚
号	號
合い	合ひ
合いい	合いい
合いきいき	合いきいき
合いくつ	合いくつ
合いくら	合いくら
合いたさ	合いたさ
合いたしま	合いたしま
合いたす	合いたす
合いたせ	合いたせ
合いたそうと	合いたさうと
合いただいた	合いただいた
合いただいて	合いただいて
合いただか	合いただか
合いただき	合いただき
合いただく	合いただく
合いただけ	合いただけ
合いただこう	合いただかう
合いっ	合いつ
合いつでも	合いつでも
合いつも	合いつも
合いろいろ	合いろいろ
合う	合ふ
合え	合へ
合おう	合はう
合わ	合は
合服	間服
豪州	濠州
轟いた	轟いた
轟いて	轟いて
克とうが	克たうが
克とうじゃ	克たうぢや
克とうで	克たうで
克とうと	克たうと
克とうに	克たうに
克とうね	克たうね
刻まず	刻まず
刻もう	刻まう
告ごう	告がう
国	國
黒ずまず	黒ずまず
黒影	黒翳
漉いた	漉いた
漉いて	漉いて
骨格	骨骼
込まず	込まず
込もう	込まう
今さら	今さら
今なお	今なほ
恨まず	恨まず
恨もう	恨まう
根づいた	根づいた
根づいて	根づいて
根底	根柢
混まず	混まず
混もう	混まう
混交	混淆
混然	渾然
左注	左註
座っ	坐つ
座ら	坐ら
座り	坐り
座る	坐る
座れ	坐れ
座ろう	坐らう
座椅子	坐椅子
座客	坐客
座繰	坐繰
座高	坐高
座骨	坐骨
座視	坐視
座州	坐洲
座礁	坐礁
座乗	坐乗
座食	坐食
座睡	坐睡
座禅	坐禪
座像	坐像
座談	坐談
座薬	坐藥
座浴	坐浴
座礼	坐礼
挫いた	挫いた
挫いて	挫いて
塞がろう	塞がらう
才知	才智
済	濟
済まず	濟まず
済もう	濟まう
砕	碎
砕いた	碎いた
砕いて	碎いて
斎	齋
斎い	齋ひ
斎う	齋ふ
斎え	齋へ
斎おう	齋はう
斎まず	齋まず
斎わ	齋は
細注	細註
裁いた	裁いた
裁いて	裁いて
裁とうが	裁たうが
裁とうじゃ	裁たうぢや
裁とうと	裁たうと
裁とうに	裁たうに
裁知	裁智
剤	劑
咲いた	咲いた
咲いて	咲いて
削ごう	削がう
削岩	鑿岩
窄もう	窄まう
桜	櫻
冊	册
擦りむいた	擦りむいた
擦りむいて	擦りむいて
雑	雜
雑踏	雜沓
捌いた	捌いた
捌いて	捌いて
錆びついた	錆びついた
錆びついて	錆びついて
三弦	三絃
三個	三箇
三差	三叉
三跡	三蹟
三編	三篇
三編集	三編輯
参	參
参勤	參覲
惨	慘
撒いた	撒いた
撒いて	撒いて
散逸	散佚
散蒔いた	散蒔いた
散蒔いて	散蒔いて
散水	撒水
散布	撒布
桟	棧
産まず	産まず
産もう	産まう
産気づいた	産氣づいた
産気づいて	産氣づいて
蚕	蠶
讃	讚
讃え	讚へ
賛	贊
賛歌	讚歌
賛仰	讚仰
賛辞	讚辭
賛嘆	讚歎
賛美	讚美
賛頌	讚頌
酸化炎	酸化焔
残	殘
残ろう	殘らう
仕え	仕へ
伺い	伺ひ
伺う	伺ふ
伺え	伺へ
伺おう	伺はう
伺わ	伺は
使い	使ひ
使いたさず	使いたさず
使いたさな	使いたさな
使いたした	使いたした
使いたして	使いたして
使いたしま	使いたしま
使いたす	使いたす
使いたせ	使いたせ
使いたそうが	使いたそうが
使いたそうと	使いたそうと
使いただいた	使いただいた
使いただいて	使いただいて
使いただか	使いただか
使いただき	使いただき
使いただく	使いただく
使いただけ	使いただけ
使いただこう	使いただかう
使う	使ふ
使え	使へ
使おう	使はう
使わ	使は
刺激	刺戟
史跡	史蹟
嗣ごう	嗣がう
四つんばい	四つんばひ
四個	四箇
四編	四篇
四編集	四編輯
思い	思ひ
思いついた	思ひついた
思いついて	思ひついて
思いまがう	思ひまがふ
思う	思ふ
思え	思へ
思おう	思はう
思わ	思は
思弁	思辨
支え	支へ
支弁	支辨
止まず	止まず
止め弁	止め瓣
止もう	止まう
死にぎわ	死にぎは
死のう	死なう
死体	屍體
死没	死歿
私書箱	私書函
私注	私註
糸	絲
糸くず	絲くづ
紫班	紫斑
至知	至智
詩編	詩篇
試練	試煉
賜い	賜ひ
賜う	賜ふ
賜え	賜へ
賜おう	賜はう
賜わ	賜は
飼い	飼ひ
飼いっぱい	飼いつぱい
飼う	飼ふ
飼え	飼へ
飼おう	飼はう
飼わ	飼は
歯	齒
事跡	事蹟
似ついた	似ついた
似ついて	似ついて
児	兒
字画	字劃
慈しまず	慈しまず
慈しもう	慈しまう
持とう、	持たう、
持とう。	持たう。
持とうか	持たうか
持とうが	持たうが
持とうじゃ	持たうじや
持とうぞ	持たうぞ
持とうで	持たうで
持とうと	持たうと
持とうに	持たうに
持とうね	持たうね
持とうもの	持たうもの
持とうや	持たうや
持とうよ	持たうよ
時めいた	時めいた
時めいて	時めいて
次ごう	次がう
耳がとお	耳がとほ
自賛	自讃
自注	自註
辞	辭
七個	七箇
七転	七顛
七編	七篇
七編集	七編輯
失い	失ひ
失いたさ	失いたさ
失いたし	失いたし
失いたす	失いたす
失いたせ	失いたせ
失いたそうと	失いたさうと
失う	失ふ
失え	失へ
失おう	失はう
失わ	失は
嫉まず	嫉まず
嫉もう	嫉まう
室弁	室瓣
湿	濕
質草	質種
実	實
偲ぼう	偲ばう
写	寫
射幸	射倖
者注	者註
車両	車輛
邪知	邪智
灼いた	灼いた
灼いて	灼いて
酌もう	酌まう
釈	釋
惹いた	惹いた
惹いて	惹いて
取りまいた	取りまいた
取りまいて	取りまいて
手ずから	手づから
手なずけ	手なづけ
手におえ	手におへ
手掛かり	手懸り
手掛り	手懸り
手跡	手蹟
手帳	手帖
首かざり	頸かざり
首かせ	頸かせ
首くくり	頸くくり
首すじ	頸すぢ
首ったけ	頸つたけ
首っぴき	頸つぴき
首っ引	頸つ引
首っ丈	頸丈
首括	頸縊
首肯いた	首肯いた
首肯いて	首肯いて
首飾	頸飾
首輪	頸環
首枷	頸枷
受注	受註
呪い	呪ひ
呪う	呪ふ
呪え	呪へ
呪おう	呪はう
呪わ	呪は
寿	壽
収	收
収拾	収拾
収集	蒐集
就いた	就いた
就いて	就いて
修練	修煉
愁い	愁ひ
愁いっ	愁いつ
愁う	愁ふ
愁え	愁へ
愁おう	愁はう
愁わ	愁は
拾い	拾ひ
拾う	拾ふ
拾え	拾へ
拾おう	拾はう
拾わ	拾は
秋めいた	秋めいた
秋めいて	秋めいて
終い	終ひ
終いかにも	終いかにも
終いたさ	終いたさ
終いたしま	終いたしま
終いたす	終いたす
終いたせば	終いたせば
終いたそうが	終いたさうが
終いたそうと	終いたさうと
終いろいろ	終いろいろ
終う	終ふ
終え	終へ
終おう	終はう
終わ	終は
終息	終熄
習い	習ひ
習いたさず	習いたさず
習いたした	習いたした
習いたして	習いたして
習いたしま	習いたしま
習いたす	習いたす
習いたせ	習いたせ
習いたそうが	習いたさうが
習いたそうと	習いたさうと
習いただい	習いただい
習いただか	習いただか
習いただき	習いただき
習いただく	習いただく
習いただけ	習いただけ
習う	習ふ
習え	習へ
習おう	習はう
習は	習は
臭いがあり	臭ひがあり
臭いがある	臭ひがある
臭いがあれ	臭ひがあれ
臭いがあれは	臭ひがあれは
臭いがあろ	臭ひがあろ
臭いがした	臭ひがした
臭いがして	臭ひがして
臭いがしな	臭ひがしな
臭いがしよ	臭ひがしよ
臭いがする	臭ひがする
臭いがすれ	臭ひがすれ
臭いがずっと	臭ひがずつと
臭いがとれ	臭ひがとれ
臭いがない	臭ひがない
臭いがなかっ	臭ひがなかつ
臭いがなかろ	臭ひがなかろ
臭いがなく	臭ひがなく
臭いがなけ	臭ひがなけ
臭いがのう	臭ひがなう
臭いが取	臭ひが取
臭いこそ	臭ひこそ
臭いしか	臭ひしか
臭いつつ	臭ひつつ
臭いつづ	臭ひつづ
臭いなど	臭ひなど
臭いのあら	臭ひのあら
臭いのあり	臭ひのあり
臭いのある	臭ひのある
臭いのあれ	臭ひのあれ
臭いのあろ	臭ひのあろ
臭いのし	臭ひのし
臭いのする	臭ひのする
臭いのすれ	臭ひのすれ
臭いのない	臭ひのない
臭いのなかっ	臭ひのなかっ
臭いのなかろ	臭ひのなかろ
臭いのなく	臭ひのなく
臭いのなけ	臭ひのなけ
臭いまく	臭ひまく
臭いまし	臭ひまし
臭います	臭ひます
臭いませ	臭ひませ
臭いまで	臭ひまで
臭いも	臭ひも
臭いもの	臭いもの
臭いもん	臭いもん
臭いを	臭ひを
臭い始	臭ひ始
臭い消し	臭ひ消し
臭い続	臭ひ續
臭う	臭ふ
臭え	臭へ
臭おう	臭はう
臭わ	臭は
臭覚	嗅覚
衆知	衆智
襲い	襲ひ
襲いたさず	襲いたさず
襲いたさない	襲いたさない
襲いたした	襲いたした
襲いたして	襲いたして
襲いたしま	襲いたしま
襲いたす	襲いたす
襲いたせ	襲いたせ
襲いたそうが	襲いたさうが
襲いたそうと	襲いたさうと
襲いたそうもの	襲いたさうもの
襲う	襲ふ
襲え	襲へ
襲おう	襲はう
襲わ	襲は
蹴躓いた	蹴躓いた
蹴躓いて	蹴躓いて
集い	集ひ
集いくら	集いくら
集いたさ	集いたさ
集いたした	集いたした
集いたして	集いたして
集いたしま	集いたしま
集いたす	集いたす
集いたせば	集いたせば
集いたそう	集いたさう
集いただいた	集いただいた
集いただいて	集いただいて
集いただか	集いただか
集いただき	集いただき
集いただく	集いただく
集いただけ	集いただけ
集いただこう	集いただかう
集いっ	集いつ
集いろいろ	集いろいろ
集う	集ふ
集え	集へ
集おう	集はう
集わ	集は
集荷	蒐荷
集成	輯成
集落	聚落
集録	輯録
住まい	住まひ
住まう	住まふ
住まえ	住まへ
住まおう	住まはう
住まず	住まず
住まわ	住まは
住もう	住まう
十個	十箇
十編	十篇
従	從
従い	從ひ
従いたさ	從いたさ
従いたし	從いたし
従いたす	從いたす
従いたせ	從いたせ
従いたそう	從いたさう
従いっさい	從いつさい
従う	從ふ
従え	從へ
従おう	從はう
従わ	從は
渋	澁
獣	獸
縦	縱
縦い	縱ひ
縦いっぱい	縱いつぱい
重弁	重瓣
銃が一丁	銃が一挺
銃が何丁	銃が何挺
銃が九丁	銃が九挺
銃が五丁	銃が五挺
銃が三丁	銃が三挺
銃が四丁	銃が四挺
銃が七丁	銃が七挺
銃が十数丁	銃が十數挺
銃が数十丁	銃が數十挺
銃が数丁	銃が數挺
銃が二丁	銃が二挺
銃が八丁	銃が八挺
銃が六丁	銃が六挺
銃は一丁	銃は一挺
銃は何丁	銃は何挺
銃は九丁	銃は九挺
銃は五丁	銃は五挺
銃は三丁	銃は三挺
銃は四丁	銃は四挺
銃は七丁	銃は七挺
銃は十数丁	銃は十數挺
銃は数十丁	銃は數十挺
銃は数丁	銃は數挺
銃は二丁	銃は二挺
銃は八丁	銃は八挺
銃は六丁	銃は六挺
銃を一丁	銃を一挺
銃を何丁	銃を何挺
銃を九丁	銃を九挺
銃を五丁	銃を五挺
銃を三丁	銃を三挺
銃を四丁	銃を四挺
銃を七丁	銃を七挺
銃を十数丁	銃を十數挺
銃を数十丁	銃を數十挺
銃を数丁	銃を數挺
銃を二丁	銃を二挺
銃を八丁	銃を八挺
銃を六丁	銃を六挺
銃一丁	銃一挺
銃九丁	銃九挺
銃五丁	銃五挺
銃三丁	銃三挺
銃四丁	銃四挺
銃七丁	銃七挺
銃数丁	銃數挺
銃二丁	銃二挺
銃八丁	銃八挺
銃六丁	銃六挺
祝い	祝ひ
祝いくら	祝いくら
祝いたさ	祝いたさ
祝いたした	祝いたした
祝いたして	祝いたして
祝いたしま	祝いたしま
祝いたす	祝いたす
祝いたせ	祝いたせ
祝いたそう	祝いたさう
祝いただいた	祝いただいた
祝いただいて	祝いただいて
祝いただか	祝いただか
祝いただく	祝いただく
祝いただけ	祝いただけ
祝いただこう	祝いただかう
祝いっ	祝いつ
祝いろいろ	祝いろいろ
祝う	祝ふ
祝え	祝へ
祝おう	祝はう
祝わ	祝は
縮かまず	縮かまず
縮まず	縮まず
縮もう	縮まう
粛	肅
熟そう	熟さう
熟まず	熟まず
出ずっぱり	出づつぱり
俊足	駿足
春めいた	春めいた
春めいて	春めいて
瞬いた	瞬いた
瞬いて	瞬いて
準え	準へ
準じ	准じ
準ず	准ず
準急	准急
準決勝	准決勝
潤い	潤ひ
潤いくら	潤いくら
潤いっ	潤いつ
潤う	潤ふ
潤え	潤へ
潤おう	潤はう
潤わ	潤は
純朴	醇朴
遵い	遵ひ
遵う	遵ふ
遵え	遵へ
遵おう	遵はう
遵わ	遵は
順じ	准じ
順ず	准ず
順ぜ	准ぜ
順守	遵守
順法	遵法
処	處
初編	初篇
所にいたって	所にゐたつて
所謂	所謂
書いた	書いた
書いて	書いて
書こう	書かう
書簡	書翰
書簡文	書簡文
書舗	書鋪
叙	敍
叙情	抒情
女といたって	女とゐたって
鋤いた	鋤いた
鋤いて	鋤いて
除いた	除いた
除いて	除いて
傷ついた	傷ついた
傷ついて	傷ついて
傷まず	傷まず
傷もう	傷まう
償い	償ひ
償いくら	償いくら
償いたさ	償いたさ
償いたし	償いたし
償いたす	償いたす
償いたせ	償いたせ
償いたそうが	償いたさうが
償いたそうと	償いたさうと
償いただいた	償いただいた
償いただいて	償いただいて
償いただか	償いただか
償いただき	償いただき
償いただく	償いただく
償いただけ	償いただけ
償いただこう	償いただかう
償いっ	償いつ
償いろいろ	償いろいろ
償う	償ふ
償え	償へ
償おう	償はう
償わ	償は
勝とう、	勝たう、
勝とう。	勝たう。
勝とう！	勝たう！
勝とうか	勝たうか
勝とうが	勝たうが
勝とうじゃ	勝たうぢや
勝とうぞ	勝たうぞ
勝とうで	勝たうで
勝とうと	勝たうと
勝とうに	勝たうに
勝とうね	勝たうね
勝とうもの	勝たうもの
勝とうよ	勝たうよ
商い	商ひ
商いくつ	商いくつ
商いくら	商いくら
商いたさず	商いたさず
商いたさな	商いたさな
商いたした	商いたした
商いたして	商いたして
商いたしま	商いたしま
商いたす	商いたす
商いたせ	商いたせ
商いたそう	商いたさう
商いちばん	商いちばん
商いっ	商いつ
商いろいろ	商いろいろ
商う	商ふ
商え	商へ
商おう	商はう
商わ	商は
唱い	唱ひ
唱いきなり	唱いきなり
唱いたさ	唱いたさ
唱いたした	唱いたした
唱いたして	唱いたして
唱いたしま	唱いたしま
唱いたす	唱いたす
唱いたせ	唱いたせ
唱いたそう	唱いたさう
唱いっ	唱いつ
唱う	唱ふ
唱え	唱へ
唱おう	唱はう
唱わ	唱は
奨	奬
将	將
小さそう	小ささう
小突いた	小突いた
小突いて	小突いて
小編	小篇
招いた	招いた
招いて	招いて
掌編	掌篇
昇叙	陞敍
昇進	陞進
昇任	陞任
消夏	銷夏
消却	銷却
消沈	銷沈
焼	燒
焼いた	燒いた
焼いて	燒いて
焼きついた	燒きついた
焼きついて	燒きついて
焦げた臭いが	焦げた臭ひが
焦げた臭いの	焦げた臭ひの
焦げた臭いも	焦げた臭ひも
焦げついた	焦げついた
焦げついて	焦げついて
焦げる臭いが	焦げる臭ひが
焦げる臭いの	焦げる臭ひの
焦げる臭いも	焦げる臭ひも
焦燥	焦躁
省いた	省いた
省いて	省いて
称	稱
称え	稱へ
称賛	稱讚
笑い	笑ひ
笑いじょうご	笑ひじやうご
笑いたさ	笑いたさ
笑いたし	笑いたし
笑いたす	笑いたす
笑いたせ	笑いたせ
笑いろ	笑いろ
笑う	笑ふ
笑え	笑へ
笑おう	笑はう
笑まず	笑まず
笑わ	笑は
衝いた	衝いた
衝いて	衝いて
証	證
象眼	象嵌
賞賛	賞讚
障害	障碍
障壁	牆壁
上編	上篇
上薬	釉藥
乗	乘
乗りかえ	乘りかへ
乗りそい	乘りそひ
乗りそう	乘りそふ
乗りそうだ	乘りさうだ
乗りそうで	乘りさうで
乗りそうな	乘りさうな
乗りそうに	乘りさうに
乗りそえ	乘りそへ
乗りそおう	乘りそはう
乗りそわ	乘りそは
乗ろう	乘らう
冗舌	饒舌
剰	剩
壌	壤
嬢	孃
情義	情誼
条	條
浄	淨
畳	疊
畳まず	疊まず
穣	穰
蒸留	蒸溜
譲	讓
醸	釀
嘱	囑
拭い	拭ひ
拭いた	拭いた
拭いたい	拭ひたい
拭いたか	拭ひたか
拭いたく	拭ひたく
拭いたけれ	拭ひたけれ
拭いて	拭いて
拭う	拭ふ
拭え	拭へ
拭おう	拭はう
拭わ	拭は
植え	植ゑ
色づいた	色づいた
色づいて	色づいて
色のさえ	色のさえ
色めい	色めい
触	觸
食い	食ひ
食いかに	食いかに
食いきなり	食いきなり
食いくら	食いくら
食いしんぼう	食ひしんばう
食いたさず	食いたさず
食いたした	食いたした
食いたして	食いたして
食いたしま	食いたしま
食いたす	食いたす
食いたせ	食いたせ
食いたそうが	食いたさうが
食いたそうと	食いたさうと
食いたそうもの	食いたさうもの
食いただいた	食いただいた
食いただいて	食いただいて
食いただか	食いただか
食いただき	食いただき
食いただく	食いただく
食いただけ	食いただけ
食いただこう	食いただかう
食いちばん	食いちばん
食いっぱい	食いつぱい
食いついた	食ひついた
食いついて	食ひついて
食いろいろ	食いろいろ
食う	食ふ
食うまいで	食うまいで
食うまいな	食うまいな
食うまいね	食うまいね
食うまいの	食うまいの
食うまいよ	食うまいよ
食え	食へ
食おう	食はう
食まず	食まず
食らい	食らひ
食らいついた	食らひついた
食らいついて	食らひついて
食らう	食らふ
食らえ	食らへ
食らおう	食らはう
食らわ	食らは
食わ	食は
食事療法	食餌療法
食甚	蝕甚
食尽	蝕甚
食像	蝕像
蝕まず	蝕まず
蝕もう	蝕まう
尻にしいた	尻にしいた
尻にしいて	尻にしいて
伸長	伸暢
侵食	侵蝕
侵略	侵掠
唇	脣
寝	寢
寝ぎわ	寢ぎは
寝ついた	寢ついた
寝ついて	寢ついて
心がいた	心がいた
心づいた	心づいた
心づいて	心づいて
慎	愼
慎まず	愼まず
慎もう	愼まう
振りまいた	振りまいた
振りまいて	振りまいて
振るい	振るひ
振るいかに	振るいかに
振るいずれ	振るいずれ
振るいちばん	振るいちばん
振るいっ	振るいっ
振るいろいろ	振るいろいろ
振るう	振るふ
振るえ	振るへ
振るおう	振るはう
振るわ	振るは
新注	新註
新編	新篇
新編集	新編輯
晋	晉
浸食	浸蝕
浸透	滲透
深いねむり	深いねむり
深知	深智
真	眞
真跡	眞蹟
親しまず	親しまず
親しもう	親しまう
進まず	進まず
進もう	進まう
針術	鍼術
震い	震ひ
震いきなり	震いきなり
震いくら	震いくら
震いたさ	震いたさ
震いたし	震いたし
震いたす	震いたす
震いたせ	震いたせ
震いたそう	震いたさう
震いっ	震いつ
震いろいろ	震いろいろ
震う	震ふ
震え	震へ
震おう	震はう
震わ	震は
人知	人智
仁知	仁智
尋問	訊問
尽	盡
訊いた	訊いた
訊いて	訊いて
靭	靱
酢酸	醋酸
図	圖
吹いた	吹いた
吹いて	吹いて
吹雪いた	吹雪いた
吹雪いて	吹雪いて
水のあわ	水のあわ
水食	水蝕
水没	水沒
炊いた	炊いた
炊いて	炊いて
粋	粹
翠	翆
衰え	衰へ
衰退	衰頽
酔	醉
酔い	醉ひ
酔いくら	酔いくら
酔いたさな	酔いたさな
酔いたした	酔いたした
酔いたして	酔いたして
酔いたしま	酔いたしま
酔いたす	酔いたす
酔いたせ	酔いたせ
酔いたそうが	酔いたさうが
酔いたそうと	酔いたさうと
酔いっ	酔いつ
酔いろいろ	酔いろいろ
酔う	醉ふ
酔え	醉へ
酔おう	醉はう
酔わ	醉は
随	隨
随い	隨ひ
随う	隨ふ
随え	隨へ
随わ	隨は
髄	髓
嵩まず	嵩まず
数	數
数え	數へ
数個	數箇
数匹	數疋
枢	樞
据え	据ゑ
澄まず	澄まず
世のならい	世のならひ
世間知	世間智
世知	世智
世論	輿論
凄まず	凄まず
凄もう	凄まう
制御	制禦
勢い	勢ひ
勢いかに	勢いかに
勢いきなり	勢いきなり
勢いくら	勢いくら
勢いずれ	勢ずれ
勢いたさ	勢いたさ
勢いたし	勢いたし
勢いたす	勢いたす
勢いたせば	勢いたせば
勢いたそう	勢いたさう
勢いちばん	勢いちばん
勢いづいた	勢ひづいた
勢いづいて	勢ひづいて
成功裏	成功裡
整い	整ひ
整いくら	整いくら
整いたさ	整いたさ
整いたし	整いたし
整いたす	整いたす
整いたせ	整いたせ
整いたそう	整いたさう
整いただいた	整いただいた
整いただいて	整いただいて
整いただか	整いただか
整いただき	整いただき
整いただく	整いただく
整いただけ	整いただけ
整いただこう	整いただかう
整いっ	整いっ
整いろいろ	整いろいろ
整う	整ふ
整え	整へ
整おう	整はう
整わ	整は
棲まず	棲まず
棲もう	棲まう
生い	生ひ
生いかなる	生いかなる
生いかに	生いかに
生いきいき	生いきいき
生いきなり	生いきなり
生いくつ	生いくつ
生いたさ	生いたさ
生いたし	生いたし
生いたす	生いたす
生いたせ	生いたせ
生いたそう	生いたさう
生いっ	生いっ
生いっぱい	生いつぱい
生いつでも	生いつでも
生いつも	生いつも
生いろいろ	生いろいろ
生えぎわ	生えぎは
生きがい	生きがひ
生きがいい	生きがいい
生きがいかに	生きがいかに
生きがいくら	生きがいくら
生きがいちばん	生きがいちばん
生まず	生まず
生まれついた	生まれついた
生まれついて	生まれついて
生もう	生まう
生息	棲息
聖跡	聖蹟
声	聲
誓い	誓ひ
誓う	誓ふ
誓え	誓へ
誓おう	誓はう
誓わ	誓は
請い	請ひ
請いかに	請いかに
請いくつ	請いくつ
請いくら	請いくら
請いずれ	請いずれ
請いたさ	請いたさ
請いたし	請いたし
請いたす	請いたす
請いたせ	請いたせ
請いたそう	請いたさう
請いっ	請いっ
請いつでも	請いつでも
請いろいろ	請いろいろ
請う	請ふ
請え	請へ
請おう	請はう
請わ	請は
静	靜
斉	齊
席巻	席倦
惜しまず	惜しまず
惜しもう	惜しまう
斥いた	斥いた
斥いて	斥いて
積まず	積まず
積もう	積まう
績まず	績まず
赤らまず	赤らまず
赤らも	赤らま
切り張	切り貼
接ごう	接がう
摂	攝
窃	竊
窃もう	竊まう
説いた	説いた
説いて	説いて
雪ごう	雪がう
絶とう、	絶たう、
絶とう。	絶たう。
絶とうか	絶たうか
絶とうが	絶たうが
絶とうじゃ	絶たうぢや
絶とうで	絶たうで
絶とうと	絶たうと
絶とうに	絶たうに
絶とうね	絶たうね
絶とうもの	絶たうもの
絶とうや	絶たうや
絶とうよ	絶たうよ
絶賛	絶讚
舌なめずり	舌なめづり
先ず	先づ
先ずる	先ずる
先ずれ	先ずれ
先鋭	尖鋭
先端	尖端
先兵	尖兵
千個	千箇
千匹	千疋
千編	千篇
占い	占ひ
占いくら	占いくら
占いたさ	占いたさ
占いたした	占いたした
占いたして	占いたして
占いたしま	占いたしま
占いたす	占いたす
占いたせ	占いたせ
占いたそうが	占いたさうが
占いたそうと	占いたさうと
占う	占ふ
占え	占へ
占おう	占はう
占わ	占は
宣い	宣ひ
宣いただ	宣いただ
宣う	宣ふ
宣え	宣へ
宣おう	宣はう
宣わ	宣は
専	專
専断	擅斷
戦	戰
戦々恐々	戰々兢々
戦い	戰ひ
戦いかに	戰いかに
戦いきなり	戰いきなり
戦いくら	戰いくら
戦いたさず	戰いたさず
戦いたさな	戰いたさな
戦いたさぬ	戰いたさぬ
戦いたした	戰いたした
戦いたして	戰いたして
戦いたしま	戰いたしま
戦いたす	戰いたす
戦いたせ	戰いたせ
戦いたそう	戰いたさう
戦いただい	戰いただい
戦いただか	戰いただか
戦いただき	戰いただき
戦いただく	戰いただく
戦いただけ	戰いただけ
戦いただこう	戰いただかう
戦いちばん	戰いちばん
戦いっ	戰いっ
戦いろいろ	戰いろいろ
戦う	戰ふ
戦え	戰へ
戦おう	戰はう
戦わ	戰は
戦没	戰歿
戦慄いた	戰慄いた
戦慄いて	戰慄いて
扇情	煽情
扇動	煽動
撰ぼう	撰ばう
浅	淺
浅いねむり	淺いねむり
洗い	洗ひ
洗う	洗ふ
洗え	洗へ
洗おう	洗はう
洗わ	洗は
洗浄	洗滌
洗練	洗煉
染まず	染まず
潜	潛
潜まず	潜まず
潜もう	潛まう
穿いた	穿いた
穿いて	穿いて
穿とう	穿たう
繊	纖
羨まず	羨まず
羨もう	羨まう
船倉	船艙
賎	賤
賎しもう	賤しまう
践	踐
践まず	踐まず
選ぼう	選ばう
選考	銓衡
銭	錢
閃いた	閃いた
閃いて	閃いて
前編	前篇
前編集	前編輯
全壊	全潰
全編	全篇
全編集	全編輯
禅	禪
繕い	繕ひ
繕う	繕ふ
繕え	繕へ
繕おう	繕はう
繕わ	繕は
措いた	措いた
措いて	措いて
曽	曾
狙い	狙ひ
狙う	狙ふ
狙え	狙へ
狙おう	狙はう
狙わ	狙は
疏注	疏註
疎もう	疎まう
疎水	疏水
疎通	疏通
疎明	疏明
組まず	組まず
組みつい	組みつい
組もう	組まう
組んずほぐれつ	組んづほぐれつ
組んず解れつ	組んづ解れつ
蘇張の弁	蘇張の辯
訴え	訴へ
阻もう	阻まう
阻害	阻碍
阻止	沮止
僧帽弁	僧帽瓣
双	雙
倉皇	蒼惶
喪い	喪ひ
喪う	喪ふ
喪え	喪へ
喪おう	喪はう
喪わ	喪は
壮	壯
惣菜	總菜
想い	想ひ
想いきなり	想いきなり
想いたさ	想いたさ
想いたし	想いたし
想いたす	想いたす
想いたせ	想いたせ
想いたそう	想いたさう
想いっ	想いつ
想いろいろ	想いろいろ
想う	想ふ
想え	想へ
想おう	想はう
想わ	想は
捜	搜
掃いた	掃いた
掃いて	掃いて
掃滅	剿滅
挿	插
挿まず	插まず
挿もう	插まう
掻いた	掻いた
掻いて	掻いて
巣くい	巣くひ
巣くう	巣くふ
巣くえ	巣くへ
巣くおう	巣くはう
巣くわ	巣くは
漕ごう	漕がう
争	爭
争い	爭ひ
争いきなり	爭いきなり
争いくつ	爭いくつ
争いくら	爭いくら
争いたさ	爭いたさ
争いたした	爭いたした
争いたして	爭いたして
争いたしま	爭いたしま
争いたす	爭いたす
争いたせ	爭いたせ
争いたそう	爭いたさう
争いただ	爭いただ
争いっ	爭いつ
争いろいろ	爭いろいろ
争う	爭ふ
争え	爭へ
争おう	爭はう
争わ	爭は
相い	相ひ
相いきいき	相いきいき
相いっ	相いつ
相いつでも	相いつでも
相いろいろ	相いろいろ
相う	相ふ
相え	相へ
相克	相剋
相打ち	相討ち
相入れ	相容れ
総	總
総合	綜合
総菜	惣菜
総連	總聯
聡	聰
聡知	聡智
荘	莊
装	裝
装い	裝ひ
装いきなり	裝いきなり
装いくつ	裝いくつ
装いくら	裝いくら
装いたさず	裝いたさず
装いたさな	裝いたさな
装いたさぬ	裝いたさぬ
装いたした	裝いたした
装いたして	裝いたして
装いたしま	裝いたしま
装いたす	裝いたす
装いたせ	裝いたせ
装いたそう	装いたさう
装いただ	裝いただ
装いっ	裝いつ
装いつでも	裝いつでも
装いろいろ	裝いろいろ
装う	裝ふ
装え	裝へ
装おう	裝はう
装わ	裝は
遭い	遭ひ
遭う	遭ふ
遭え	遭へ
遭おう	遭はう
遭わ	遭は
騒	騷
騒ごう	騷がう
増注	増註
憎まず	憎まず
憎もう	憎まう
臓	臟
蔵	藏
側聞	仄聞
即知	即智
息づいた	息づいた
息づいて	息づいて
息まいた	息まいた
息まいて	息まいて
息巻いた	息卷いた
息巻いて	息卷いて
捉え	捉へ
足掻いた	足掻いた
足掻いて	足掻いて
俗知	俗智
属	屬
族生	簇生
続	續
続いた	續いた
続いて	續いて
続編	續篇
揃い	揃ひ
揃う	揃ふ
揃え	揃へ
揃おう	揃はう
揃わ	揃は
存え	存へ
尊ぼう	尊ばう
損い	損ひ
損いたさ	損いたさ
損いたし	損いたし
損いたす	損いたす
損いたせ	損いたせ
損いたそう	損いたさう
損う	損ふ
損え	損へ
損おう	損はう
損ない	損なひ
損なう	損なふ
損なえ	損なへ
損なおう	損なはう
損なわ	損なは
損わ	損は
他生の縁	多生の縁
多知	多智
多弁	多辯
堕	墮
打ち死に	討ち死に
打とう。	打たう。
打とうか	打たうか
打とうが	打たうが
打とうじゃ	打たうぢや
打とうで	打たうで
打とうと	打たうと
打とうに	打たうに
打とうね	打たうね
打とうもの	打たうもの
打とうや	打たうや
打とうよ	打たうよ
駄弁	駄辯
体	體
体制をしいて	體制をしいて
対	對
対話編	對話篇
耐え	耐へ
帯	帶
待ちあぐまず	待ちあぐまず
待とう、	待たう、
待とう。	待たう。
待とうか	待たうか
待とうが	待たうが
待とうじゃ	待たうぢや
待とうぞ	待たうぞ
待とうで	待たうで
待とうと	待たうと
待とうなら	待たうなら
待とうに	待たうに
待とうね	待たうね
待とうもの	待たうもの
待とうや	待たうや
待とうよ	待たうよ
戴いた	戴いた
戴いて	戴いて
替え	替へ
替わ	替は
滞	滯
袋とじ	袋とぢ
退いた	退いた
退いて	退いて
退きぎわ	退きぎは
退け	斥け
退色	褪色
退勢	頽勢
退廃	頽廢
代え	代へ
代わ	代は
代弁	代辯
台	臺
台頭	擡頭
台風	颱風
大阪弁	大阪辯
大知	大智
大編	大篇
大編集	大編輯
大弁	大辯
滝	瀧
啄まず	啄まず
啄もう	啄まう
択	擇
拓いた	拓いた
拓いて	拓いて
沢	澤
濯い	濯ひ
濯う	濯ふ
濯え	濯へ
濯おう	濯はう
濯ごう	濯がう
濯わ	濯は
諾い	諾ひ
諾う	諾ふ
諾え	諾へ
諾おう	諾はう
諾わ	諾は
叩いた	叩いた
叩いて	叩いて
達	逹
奪い	奪ひ
奪いくら	奪いくら
奪いたさず	奪いたさず
奪いたさな	奪いたさな
奪いたさぬ	奪いたさぬ
奪いたした	奪いたした
奪いたして	奪いたして
奪いたしま	奪いたしま
奪いたす	奪いたす
奪いたせ	奪いたせ
奪いたそう	奪いたさう
奪う	奪ふ
奪え	奪へ
奪おう	奪はう
奪わ	奪は
奪略	奪掠
脱ごう	脱がう
狸	貍
誰といたって	誰とゐたつて
単	單
単座	單坐
単弁	單瓣
嘆い	歎い
嘆か	歎か
嘆かわし	歎かはし
嘆き	歎き
嘆く	歎く
嘆け	歎け
嘆こう	歎かう
嘆じ	嘆じ
嘆ず	嘆ず
嘆願	歎願
嘆訴	歎訴
嘆息	歎息
嘆嗟	歎嗟
担	擔
担い	擔ひ
担いだ	擔いだ
担いっ	擔いつ
担いで	擔いで
担う	擔ふ
担え	擔へ
担おう	擔はう
担ごう	擔がう
担わ	擔は
湛え	湛ヘ
炭鉱	炭礦
短いねむり	短いねむり
短編	短篇
端座	端坐
胆	膽
鍛え	鍛へ
団	團
弾	彈
弾いた	彈いた
弾いて	彈いて
弾まず	弾まず
弾もう	彈まう
弾もう	彈まう　
断	斷
断とう、	斷たう、
断とう。	斷たう。
断とうか	斷たうか
断とうが	斷たうが
断とうこと	斷たうこと
断とうじゃ	斷たうぢや
断とうで	斷たうで
断とうと	斷たうと
断とうに	斷たうに
断とうね	斷たうね
断とうもの	斷たうもの
断とうや	斷たうや
断とうよ	斷たうよ
断編	斷篇
暖房	煖房
暖炉	煖爐
知育	智育
知恵	智慧
知計	智計
知歯	智歯
知者	智者
知術	智術
知将	智将
知嚢	智嚢
知能	智能
知弁	智辯
知謀	智謀
知略	智略
知慮	智慮
知力	智力
地滑り	地辷り
弛まず	弛まず
弛もう	弛まう
恥じ	恥ぢ
恥じらい	恥ぢらひ
恥じらう	恥ぢらふ
恥じらえ	恥ぢらへ
恥じらおう	恥ぢらはう
恥じらわ	恥ぢらは
恥ず	恥づ
痴	癡
痴れ	癡れ
痴者	癡者
置いた	置いた
置いて	置いて
置きわすれ	置きわすれ
遅	遲
築いた	築いた
築いて	築いて
蓄え	蓄へ
蓄音機	蓄音器
逐い	逐ひ
逐う	逐ふ
逐え	逐へ
逐おう	逐はう
逐わ	逐は
着いた	着いた
着いて	着いて
中編	中篇
抽選	抽籤
昼	晝
注ごう	注がう
注解	註解
注記	註記
注脚	註脚
注釈	註釋
注説	註説
注疏	註疏
注文	註文
注本	註本
虫	蟲
虫くい	蟲くひ
鋳	鑄
猪	豬
著わ	著は
貯え	貯へ
丁々	打々
丁のピストル	挺のピストル
丁の火縄銃	挺の火繩銃
丁の機関銃	挺の機關銃
丁の拳銃	挺の拳銃
丁の散弾銃	挺の散彈銃
丁の自動小銃	挺の自動小銃
丁の銃	挺の銃
丁ピストル	挺ピストル
丁拳銃	挺拳銃
丁重	鄭重
丁銃	挺銃
丁寧	叮嚀
凋もう	凋まう
庁	廳
弔い	弔ひ
弔う	弔ふ
弔え	弔へ
弔おう	弔はう
弔わ	弔は
張りつけ	貼りつけ
張り紙	貼り紙
張り替え	貼り替へ
張り付	貼り附
挑まず	挑まず
挑もう	挑まう
挑発	挑撥
聴	聽
聴いた	聽いた
聴いて	聽いて
脹らもう	脹らまう
調い	調ひ
調いたさ	調いたさ
調いたし	調いたし
調いたす	調いたす
調いたせ	調いたせ
調いたそう	調いたさう
調いただ	調いただ
調う	調ふ
調え	調へ
調おう	調はう
調わ	調は
調子づいた	調子づいた
調子づいて	調子づいて
跳ぼう	跳ばう
長いねむり	長いねむり
長らえ	長らへ
長編	長篇
頂いた	頂いた
頂いて	頂いて
鳥観図	鳥瞰図
勅	敕
勅書	勅書
勅撰	勅撰
勅命	勅命
沈まず	沈まず
沈もう	沈まう
沈殿	沈澱
沈没	沈沒
賃金	賃銀
鎮	鎭
鎮まず	鎭まず
陳ぼう	陳ばう
津軽弁	津軽辯
津波	津浪
追い	追ひ
追いついた	追ひついた
追いついて	追ひついて
追う	追ふ
追え	追へ
追おう	追はう
追わ	追は
追随	追随
痛まず	痛まず
痛もう	痛まう
通い	通ひ
通いかに	通いかに
通いずれ	通いずれ
通いたさず	通いたさず
通いたさな	通いたさな
通いたさぬ	通いたさぬ
通いたした	通いたした
通いたして	通いたして
通いたしま	通いたしま
通いたす	通いたす
通いたせ	通いたせ
通いたそう	通いたさう
通いただいた	通いただいた
通いただいて	通いただいて
通いただか	通いただか
通いただき	通いただき
通いただく	通いただく
通いただけ	通いただけ
通いただこう	通いただかう
通いちばん	通いちばん
通う	通ふ
通え	通へ
通おう	通はう
通わ	通は
掴まず	掴まず
掴もう	掴まう
綴じ	綴ぢ
壷	壺
釣りざお	釣りざを
低回	低徊
停泊	碇泊
定年	停年
抵触	牴觸
逓	遞
鄭注	鄭註
泥まず	泥まず
摘まず	摘まず
摘もう	摘まう
敵い	敵ひ
敵いっぱい	敵いつぱい
敵う	敵ふ
敵え	敵へ
敵おう	敵はう
敵わ	敵は
適い	適ひ
適いっ	適いつ
適う	適ふ
適え	適へ
適おう	適はう
適わ	適は
鉄	鐵
天下っ	天降つ
天下ら	天降ら
天下り	天降り
天下る	天降る
天下れ	天降れ
天下ろ	天降ら
添い	添ひ
添う	添ふ
添え	添へ
添え書き	添へ書き
添おう	添はう
添わ	添は
纏い	纏ひ
纏う	纏ふ
纏え	纏へ
纏おう	纏はう
纏わ	纏は
転	轉
転ぼう	轉ばう
転倒	顛倒
転落	顛落
点	點
点いた	點いた
点いて	點いて
伝	傳
伝い	傳ひ
伝いかに	傳いかに
伝いくつ	傳いくつ
伝いたさ	傳いたさ
伝いたし	傳いたし
伝いたす	傳いたす
伝いたせ	傳いたせ
伝いたそう	傳いたさう
伝いただ	傳いただ
伝いちばん	傳いちばん
伝いっ	傳いつ
伝いろいろ	傳いろいろ
伝う	傳ふ
伝え	傳へ
伝おう	傳はう
伝わ	傳は
吐い	吐い
妬いた	妬いた
妬いて	妬いて
妬まず	妬まず
妬もう	妬まう
途絶	杜絶
途絶え	跡絶え
土佐弁	土佐辯
倒壊	倒潰
党	黨
凍てついた	凍てついた
凍てついて	凍てついて
悼まず	悼まず
悼もう	悼まう
投票箱	投票函
東北弁	東北辯
盗	盜
盗まず	盜まず
盗もう	盜まう
盗もうま	盜まうま
湯がいた	湯がいた
湯がいて	湯がいて
涛	濤
灯	燈
当	當
当てはずれ	當てはづれ
答え	答へ
答弁	答辯
討とうか	討たうか
討とうが	討たうが
討とうじゃ	討たうぢや
討とうぞ	討たうぞ
討とうで	討たうで
討とうと	討たうと
討とうもの	討たうもの
踏ま	蹈ま
踏まえ	蹈まへ
踏まず	蹈まず
踏み	蹈み
踏む	蹈む
踏め	蹈め
踏もう	蹈まう
踏ん	蹈ん
踏襲	蹈襲
透いた	透いた
透いて	透いて
頭のさえ	頭のさえ
頭注	頭註
闘	鬪
闘い	鬪ひ
闘いくら	鬪いくら
闘いたさ	鬪いたさ
闘いたし	鬪いたし
闘いたす	鬪いたす
闘いたせ	鬪いたせ
闘いたそうが	鬪いたさうが
闘いたそうと	鬪いたさうと
闘いただ	鬪いただ
闘いろいろ	鬪いろいろ
闘う	鬪ふ
闘え	鬪へ
闘おう	鬪はう
闘わ	鬪は
働いた	働いた
働いて	働いて
動いた	動いた
動いて	動いて
導いた	導いた
導いて	導いて
胴上げ	胴揚げ
道はとお	道はとほ
匿い	匿ひ
匿う	匿ふ
匿え	匿へ
匿おう	匿はう
匿わ	匿は
特集	特輯
特注	特註
毒づいた	毒づいた
毒づいて	毒づいて
独	獨
読	讀
読まず	讀まず
読もう	讀まう
突いた	突いた
突いて	突いて
突っついた	突つついた
突っついて	突つついて
突然おそい	突然おそい
届	屆
届い	屆い
頓知	頓智
呑まず	呑まず
呑もう	呑まう
謎めいた	謎めいた
謎めいて	謎めいて
馴染まず	馴染まず
馴染もう	馴染まう
縄	繩
難いずれ	難いずれ
二個	二箇
二編	二篇
二編集	二編輯
弐	貳
匂い	匂ひ
匂う	匂ふ
匂え	匂へ
匂おう	匂はう
匂わ	匂は
賑い	賑ひ
賑う	賑ふ
賑え	賑へ
賑おう	賑はう
賑わ	賑は
賑わい	賑はひ
賑わう	賑はふ
賑わえ	賑はへ
賑わおう	賑ははう
賑わわ	賑はは
日食	日蝕
妊	姙
忍ぼう	忍ばう
祢	禰
熱弁	熱辯
年保育	年保育
燃料弁	燃料瓣
粘ついた	粘ついた
粘ついて	粘ついて
悩	惱
悩まず	惱まず
悩もう	惱まう
能い	能ひ
能いくら	能いくら
能いっ	能いつ
能いろいろ	能いろいろ
能う	能ふ
能え	能へ
能おう	能はう
能わ	能は
能弁	能辯
脳	腦
脳裏	腦裡
膿まず	膿まず
膿もう	膿まう
覗いた	覗いた
覗いて	覗いて
播いた	播いた
播いて	播いて
覇	霸
波食	波蝕
波打ちぎわ	波打ちぎは
波乱	波瀾
破いた	破いた
破いて	破いて
破棄	破毀
破砕	破摧
廃	廢
廃棄	廢毀
廃虚	廢墟
拝	拜
拝まず	拜まず
拝もう	拜まう
排気弁	拜氣瓣
排出弁	拜出瓣
背いた	背いた
背いて	背いて
背徳	悖徳
背反	背叛
培い	培ひ
培う	培ふ
培え	培へ
培おう	培はう
培わ	培は
媒酌	媒妁
買い	買ひ
買いかに	買いかに
買いきなり	買いきなり
買いくら	買いくら
買いたさず	買いたさず
買いたさな	買いたさな
買いたさぬ	買いたさぬ
買いたした	買いたした
買いたして	買いたして
買いたしま	買いたしま
買いたす	買いたす
買いたせ	買いたせ
買いたそうか	買いたさうか
買いたそうが	買いたさうが
買いたそうと	買いたさうと
買いっさい	買いつさい
買いっぱい	買いつぱい
買いつでも	買いつでも
買う	買ふ
買え	買へ
買おう	買はう
買わ	買は
売	賣
這い	這ひ
這う	這ふ
這え	這へ
這おう	這はう
這わ	這は
蝿	蠅
矧ごう	矧がう
剥いた	剥いた
剥いて	剥いて
剥ごう	剥がう
博多弁	博多辯
白もう	白まう
白亜	白堊
白波	白浪
薄幸	薄倖
麦	麥
箱弁	箱辨
肌あい	肌あひ
八個	八箇
八編	八篇
八編集	八編輯
発	發
発とう、	發たう、
発とう。	發たう。
発とうか	發たうか
発とうが	發たうが
発とうじゃ	發たうぢや
発とうぞ	發たうぞ
発とうで	發たうで
発とうと	發たうと
発とうに	發たうに
発とうね	發たうね
発とうもの	發たうもの
発とうや	發たうや
発とうよ	發たうよ
発酵	醗酵
発条	撥条
髪	髮
伐とうが	伐たうが
伐とうじゃ	伐たうぢや
伐とうぞ	伐たうぞ
伐とうで	伐たうで
伐とうと	伐たうと
伐とうに	伐たうに
伐とうもの	伐たうもの
抜	拔
抜い	拔い
抜粋	拔萃
伴い	伴ひ
伴う	伴ふ
伴え	伴へ
伴おう	伴はう
伴わ	伴は
半月弁	半月瓣
反旗	叛旗
反逆	叛逆
反抗	叛抗
反賊	叛賊
反発	反撥
反乱	叛亂
班点	斑點
繁殖	蕃殖
繁盛	繁昌
煩い	煩ひ
煩う	煩ふ
煩え	煩へ
煩おう	煩はう
煩わ	煩は
飯ごう	飯がふ
挽いた	挽いた
挽いて	挽いて
番い	番ひ
番いい	番いい
番いたさ	番いたさ
番いたし	番いたし
番いたす	番いたす
番いたせ	番いたせ
番いたそう	番いたさう
番う	番ふ
番え	番へ
番おう	番はう
番わ	番は
盤石	磐石
蛮	蠻
蛮族	蕃族
卑しもう	卑しまう
庇い	庇ひ
庇う	庇ふ
庇え	庇へ
庇おう	庇はう
庇わ	庇は
彼といたって	彼とゐたって
悲しまず	悲しまず
悲しもう	悲しまう
悲嘆	悲歎
披歴	披瀝
比え	比へ
比喩	譬喩
皮むいた	皮むいた
皮むいて	皮むいて
秘	祕
秘跡	祕蹟
秘密裏	秘密裡
被い	被ひ
被う	被ふ
被え	被へ
被おう	被はう
被わ	被は
飛びついた	飛びついた
飛びついて	飛びついて
飛ぼう	飛ばう
飛語	蜚語
備え	備へ
備わ	備は
微笑もう	微笑まう
微睡まず	微睡まず
微睡もう	微睡まう
鼻ごえ	鼻ごゑ
匹	疋
筆跡	筆蹟
桧	檜
百個	百箇
百編	百篇
標注	標註
漂い	漂ひ
漂う	漂ふ
漂うて	漂うて
漂え	漂へ
漂おう	漂はう
漂わ	漂は
漂然	飄然
表わ	表は
評注	評註
描いた	描いた
描いて	描いて
病まず	病まず
病みついた	病みついた
病みついて	病みついて
病もう	病まう
病没	病歿
浜	濱
付	附
付いた	附いた
付いて	附いて
付きそい	附きそひ
付きそう	附きそふ
付きそうだ	附きさうだ
付きそうで	附きさうで
付きそうな	附きさうな
付きそうに	附きさうに
付きそえ	附きそへ
付きそおう	附きそはう
付きそわ	附きそは
付随	附随
付注	附註
付法	付法
富まず	富まず
富もう	富まう
布いた	布いた
布いて	布いて
布をしいた	布をしいた
布をしいて	布をしいて
布団	蒲團
布団をしいた	蒲團をしいた
布団をしいて	蒲團をしいて
敷いた	敷いた
敷いて	敷いて
浮いた	浮いた
浮いて	浮いて
浮かぼう	浮かばう
浮ついた	浮ついた
浮ついて	浮ついて
浮腫まず	浮腫まず
浮遊	浮游
符丁	符牒
腐食	腐蝕
腐乱	腐爛
負い	負ひ
負いたさ	負いたさ
負いたし	負いたし
負いたす	負いたす
負いたせ	負いたせ
負いたそう	負いたさう
負いただ	負いただ
負いろいろ	負いろいろ
負う	負ふ
負え	負へ
負おう	負はう
負わ	負は
赴いた	赴いた
赴いて	赴いて
附いた	附いた
附いて	附いて
舞い	舞ひ
舞う	舞ふ
舞え	舞へ
舞おう	舞はう
舞わ	舞は
舞踏	舞蹈
部屋にしいた	部屋にしいた
部屋にしいて	部屋にしいて
風刺	諷刺
風食	風蝕
葺いた	葺いた
葺いて	葺いて
副い	副ひ
副う	副ふ
副え	副へ
副おう	副はう
副わ	副は
福島弁	福島辯
覆い	覆ひ
覆う	覆ふ
覆え	覆へ
覆おう	覆はう
覆わ	覆は
払	拂
払い	拂ひ
払いずみ	拂ひずみ
払う	拂ふ
払え	拂へ
払おう	拂はう
払わ	拂は
仏	佛
物おじ	物おぢ
物怖じ	物怖ぢ
分かとうが	分かたうが
噴いた	噴いた
噴いて	噴いて
焚いた	焚いた
焚いて	焚いて
奮い	奮ひ
奮いたさ	奮いたさ
奮いたした	奮いたした
奮いたして	奮いたして
奮いたしま	奮いたしま
奮いたす	奮いたす
奮いたせ	奮いたせ
奮いたそうが	奮いたさうが
奮いたそうと	奮いたさうと
奮いただか	奮いただか
奮いただき	奮いただき
奮いただく	奮いただく
奮いただけ	奮いただけ
奮いただこう	奮いただかう
奮う	奮ふ
奮え	奮へ
奮おう	奮はう
奮わ	奮は
粉装	扮裝
紛い	紛ひ
紛う	紛ふ
紛え	紛へ
紛おう	紛はう
紛わ	紛は
聞いた	聞いた
聞いて	聞いて
聞きまがう	聞きまがふ
平和裏	平和裡
弊舗	弊鋪
並ば	竝ば
並び	竝び
並ぶ	竝ぶ
並べ	竝べ
並ぼう	竝ばう
並ん	竝ん
閉じ	閉ぢ
僻まず	僻まず
別注	別註
蔑まず	蔑まず
蔑もう	蔑まう
変	變
変え	變へ
変わ	變は
片づいた	片づいた
片づいて	片づいて
編まず	編まず
編もう	編まう
編者注	編者註
編首	篇首
編集	編輯
編集者注	編輯者註
編集注	編輯註
編章	篇章
編注	編註
編尾	篇尾
編目	篇目
辺	邊
辺境	邊疆
返り打	返り討
弁じ	辯じ
弁ず	辯ず
弁ぜ	辯ぜ
弁解	辯解
弁官	辨官
弁韓	弁韓
弁慶	辨慶
弁護	辯護
弁告	辨告
弁才	辯才
弁済	辨濟
弁財天	辨財天
弁士	辯士
弁辞	辯辭
弁識	辨識
弁釈	辯釋
弁償	辨償
弁証	辨證
弁舌	辯舌
弁辰	弁辰
弁天	辨天
弁当	辨當
弁難	辯難
弁駁	辯駁
弁髪	辮髮
弁別	辨別
弁膜	瓣膜
弁務	辨務
弁明	辯明
弁理	辨理
弁論	辯論
弁鰓	瓣鰓
保とう。	保たう。
保とうか	保たうか
保とうが	保たうが
保とうじゃ	保たうぢや
保とうで	保たうで
保とうと	保たうと
保とうに	保たうに
保とうね	保たうね
保とうもの	保たうもの
保とうや	保たうや
保とうよ	保たうよ
保育	哺育
保育園	保育園
保育所	保育所
保母	保姆
保塁	堡塁
舗石	鋪石
舗装	鋪裝
舗道	鋪道
捕らえ	捕らへ
歩いた	歩いた
歩いて	歩いて
歩まず	歩まず
歩もう	歩まう
補い	補ひ
補いくつ	補いくつ
補いくら	補いくら
補いずれ	補いずれ
補いたさ	補いたさ
補いたした	補いたした
補いたして	補いたして
補いたしま	補いたしま
補いたす	補いたす
補いたせ	補いたせ
補いたそう	補いたさう
補いただか	補いただか
補いただき	補いただき
補いただく	補いただく
補いただけ	補いただけ
補いただこう	補いただかう
補いっ	補いつ
補いろいろ	補いろいろ
補う	補ふ
補え	補へ
補おう	補はう
補わ	補は
補佐	輔佐
補助	輔助
補注	補註
補導	輔導
穂	穗
慕い	慕ひ
慕いたさず	慕いたさず
慕いたさな	慕いたさな
慕いたさぬ	慕いたさぬ
慕いたし	慕いたし
慕いたす	慕いたす
慕いたせ	慕いたせ
慕いたそう	慕いたさう
慕う	慕ふ
慕え	慕へ
慕おう	慕はう
慕わ	慕は
暮れなずむ	暮れなづむ
母指	拇指
倣い	倣ひ
倣う	倣ふ
倣え	倣へ
倣おう	倣はう
倣わ	倣は
包まず	包まず
包もう	包まう
包帯	繃帶
包丁	庖丁
呆れかえ	呆れかへ
報い	報い
報う	報ふ
報え	報へ
報おう	報はう
報わ	報は
宝	寶
崩壊	崩潰
抱いた	抱いた
抱いて	抱いて
抱え	抱へ
抱きついた	抱きついた
抱きついて	抱きついて
放とう。	放たう。
放とうか	放たうか
放とうが	放たうが
放とうじゃ	放たうぢや
放とうで	放たうで
放とうと	放たうと
放とうに	放たうに
放とうね	放たうね
放とうもの	放たうもの
放とうよ	放たうよ
放逸	放佚
放棄	抛棄
放却	抛却
放物	抛物
放擲	抛擲
縫い	縫ひ
縫う	縫ふ
縫え	縫へ
縫おう	縫はう
縫わ	縫は
芳純	芳醇
萌	萠
褒	襃
訪い	訪ひ
訪う	訪ふ
訪え	訪へ
訪おう	訪はう
訪わ	訪は
豊	豐
飽いた	飽いた
飽いて	飽いて
亡ぼう	亡ばう
傍注	旁註
妨害	妨碍
暴いた	暴いた
暴いて	暴いて
暴露	曝露
望まず	望まず
望もう	望まう
膨らもう	膨らまう
膨大	厖大
膨張	膨脹
膨張弁	膨張瓣
謀反	謀叛
防ごう	防がう
防圧	防遏
防御	防禦
墨跡	墨蹟
没	沒
没、	歿、
没。	歿。
没後	歿後
没前	歿前
没年	歿年
本編	本篇
本編集	本編輯
翻	飜
摩損	磨損
摩滅	磨滅
摩耗	磨耗
磨いた	磨いた
磨いて	磨いて
槙	槇
侭	儘
万	萬
万箇	萬箇
満	滿
味わい	味はひ
味わう	味はふ
味わえ	味はへ
味わおう	味ははう
味わっ	味はつ
味わわ	味はは
脈拍	脈搏
夢がかない	夢がかなひ
夢はかない	夢はかない
夢もかない	夢もかなひ
無さそう	無ささう
無知	無智
名古屋弁	名古屋辯
明らも	明らま
明知	明智
明弁	明辯
迷い	迷ひ
迷う	迷ふ
迷え	迷へ
迷おう	迷はう
迷わ	迷は
鳴いた	鳴いた
鳴いて	鳴いて
滅ぼう	滅ばう
綿花	棉花
綿実	棉実
模さ	摸さ
模し	摸し
模す	摸す
模せ	摸せ
模そう	摸さう
模擬	摸擬
模索	摸索
模写	摸寫
模造	摸造
模倣	摸倣
模本	摸本
妄弁	妄辯
毛むくじゃら	毛むくぢやら
毛穴	毛孔
盲執	妄執
盲動	妄動
網をしいて	網をしいて
黙	默
目だとう	目だたう
目論まず	目論まず
目論もう	目論まう
餅	餠
貰い	貰ひ
貰う	貰ふ
貰え	貰へ
貰おう	貰はう
貰わ	貰は
問い	問ひ
問いくつ	問いくつ
問いたさ	問いたさ
問いたし	問いたし
問いたす	問いたす
問いたせ	問いたせ
問いたそう	問いたさう
問いただい	問いただい
問いただか	問いただか
問いただき	問いただき
問いただく	問いただく
問いただけ	問いただけ
問いただこう	問いただかう
問いっ	問いつ
問いろいろ	問いろいろ
問う	問ふ
問え	問へ
問おう	問はう
問わ	問は
野卑	野鄙
弥	彌
薬	藥
薬舗	藥鋪
訳	譯
訳者注	譯者註
訳注	譯註
薮	藪
油送船	油槽船
勇まず	勇まず
友宜	友誼
憂い	憂ひ
憂う	憂ふ
憂え	憂へ
憂おう	憂はう
憂わ	憂は
有知	有智
湧いた	湧いた
湧いて	湧いて
涌いた	涌いた
涌いて	涌いて
誘い	誘ひ
誘う	誘ふ
誘え	誘へ
誘おう	誘はう
誘わ	誘は
遊ぼう	遊ばう
遊まず	遊まず
遊泳	游泳
遊魚	游魚
雄編	雄篇
雄編集	雄編輯
雄弁	雄辯
予	豫
余	餘
余は	余は
余輩	余輩
与	與
与え	與へ
誉	譽
揺	搖
揺らごう	搖らがう
揺らめい	搖らめい
揺るごう	搖るがう
揺蕩い	搖蕩ひ
揺蕩う	搖蕩ふ
揺蕩え	搖蕩へ
揺蕩おう	搖蕩はう
揺蕩わ	搖蕩は
様	樣
溶いた	溶いた
溶いて	溶いて
溶岩	熔岩
溶鉱	鎔鑛
溶接	熔接
用い	用ゐ
用弁	用辨
謡	謠
謡い	謠ひ
謡いい	謠いい
謡いっぱい	謠いつぱい
謡う	謠ふ
謡うた	謠うた
謡え	謠へ
謡おう	謠はう
謡わ	謠は
遥	遙
養い	養ひ
養う	養ふ
養え	養へ
養おう	養はう
養わ	養は
抑え	抑へ
欲	慾
欲さ	欲さ
欲し	欲し
欲す	欲す
欲せ	欲せ
欲そ	欲さ
欲界	欲界
欲塵	欲塵
欲有	欲有
浴びせたお	浴びせたふ
翼弁	翼瓣
来	來
頼まず	頼まず
頼もう	頼まう
絡まず	絡まず
絡みついた	絡みついた
絡みついて	絡みついて
絡もう	絡まう
落後が	落伍が
落後し	落伍し
落後す	落伍す
落後せ	落伍せ
落後は	落伍は
落後も	落伍も
落後を	落伍を
落後者	落伍者
落盤	落磐
乱	亂
乱悪	濫惡
乱獲	濫獲
乱掘	濫掘
乱作	濫作
乱製	濫製
乱僧	濫僧
乱造	濫造
乱読	濫讀
乱売	濫賣
乱発	濫發
乱伐	濫伐
乱費	濫費
乱用	濫用
乱立	濫立
覧	覽
利いた	利いた
利いて	利いて
利口	悧口
履いた	履いた
履いて	履いて
理屈	理窟
理知	理智
里謡	俚謡
離反	離叛
率い	率ゐ
立ちすくまず	立ちすくまず
立ちのいた	立ちのいた
立ちのいて	立ちのいて
立ちんぼう	立ちんばう
立ち込め	立ち籠め
立て込	立て籠
立とう、	立たう、
立とう。	立たう。
立とう！	立たう！
立とうか	立たうか
立とうが	立たうが
立とうじゃ	立たうぢや
立とうで	立たうで
立とうと	立たうと
立とうに	立たうに
立とうね	立たうね
立とうもの	立たうもの
立とうや	立たうや
立とうよ	立たうよ
略取	掠取
略奪	掠奪
流離い	流離ひ
流離う	流離ふ
流離え	流離へ
流離おう	流離はう
流離わ	流離は
留飲	溜飲
留出	溜出
留分	溜分
竜	龍
竜骨弁	龍骨瓣
了解	諒解
了見	料簡
了承	諒承
両	兩
両め	輛め
両生	兩棲
両編成	輛編成
凌ごう	凌がう
涼まず	涼まず
涼もう	涼まう
猟	獵
良い臭い	良い臭ひ
良さそう	良ささう
力もう	力まう
臨まず	臨まず
臨終	臨終
輪郭	輪廓
瑠	璢
塁	壘
涙	泪
涙ぐまず	泪ぐまず
涙ぐもう	泪ぐまう
涙液	涙液
涙管	涙管
涙香	涙香
涙痕	涙痕
涙小管	涙小管
涙腺	涙腺
涙道	涙道
類い	類ひ
類いなくて	類ひなくて
類いろいろ	類いろいろ
例え	例へ
励	勵
励まず	勵まず
励もう	勵まう
礼	禮
礼賛	禮讚
隷	隸
霊	靈
霊知	靈智
齢	齡
歴青	瀝青
列ぼう	列ばう
裂いた	裂いた
裂いて	裂いて
恋	戀
恋い	戀ひ
恋いかに	戀いかに
恋いくつ	戀いくつ
恋いくら	戀いくら
恋いたさ	戀いたさ
恋いたし	戀いたし
恋いたす	戀いたす
恋いたせ	戀いたせ
恋いたそう	戀いたさう
恋いちばん	戀いちばん
恋いっ	戀いつ
恋いろいろ	戀いろいろ
恋う	戀ふ
恋え	戀へ
恋おう	戀はう
恋わ	戀は
練炭	煉炭
練乳	煉乳
練磨	錬磨
連まず	連まず
連れそい	連れそひ
連れそう	連れそふ
連れそうだ	連れさうだ
連れそうで	連れさうで
連れそうな	連れさうな
連れそうに	連れさうに
連れそえ	連れそへ
連れそおう	連れそはう
連れそわ	連れそは
連関	聯關
連句	聯句
連係	連繋
連碁	聯碁
連合	聯合
連座	連坐
連軸	聯軸
連珠	聯珠
連想	聯想
連隊	聯隊
連弾	聯彈
連邦	聯邦
連盟	聯盟
連絡	聯絡
連立	聯立
炉	爐
露わ	露は
労	勞
労い	勞ひ
労いかに	勞いかに
労いくつ	勞いくつ
労いくら	勞いくら
労いたさ	勞いたさ
労いたし	勞いたし
労いたす	勞いたす
労いたせ	勞いたせ
労いたそう	勞いたさう
労いただい	勞いただい
労いただか	勞いただか
労いただき	勞いただき
労いただく	勞いただく
労いただけ	勞いただけ
労いただこう	勞いただかう
労いちばん	勞いちばん
労いっ	勞いつ
労いつでも	勞いつでも
労いろいろ	勞いろいろ
労う	勞ふ
労え	勞へ
労おう	勞はう
労わ	勞は
弄ぼう	弄ばう
楼	樓
狼狽え	狼狽へ
篭	籠
老いた	老いた
老いて	老いて
老舗	老鋪
六個	六箇
六編	六篇
六編集	六編輯
禄	祿
論い	論ひ
論いい	論いい
論いかに	論いかに
論いきなり	論いきなり
論いくつ	論いくつ
論いくら	論いくら
論いたさ	論いたさ
論いたし	論いたし
論いたす	論いたす
論いたせ	論いたせ
論いたそう	論いたさう
論いただ	論いただ
論いっ	論いつ
論いつでも	論いつでも
論いろいろ	論いろいろ
論う	論ふ
論え	論へ
論お	論は
論わ	論は
論弁	論辯
和え	和へ
和まず	和まず
和もう	和まう
和気あいあい	和氣あいあい
歪まず	歪まず
歪もう	歪まう
賄い	賄ひ
賄う	賄ふ
賄え	賄へ
賄おう	賄はう
賄わ	賄は
脇路弁	脇路瓣
惑い	惑ひ
惑いくら	惑いくら
惑いたさ	惑いたさ
惑いたし	惑いたし
惑いたす	惑いたす
惑いたせ	惑いたせ
惑いたそう	惑いたさう
惑いっ	惑いつ
惑いろいろ	惑いろいろ
惑う	惑ふ
惑え	惑へ
惑おう	惑はう
惑わ	惑は
亘	亙
藁ぼうし	藁ぼふし
湾	灣
湾曲	彎曲
湾入	彎入
腕のさえ	腕のさえ
腕輪	腕環
佇まず	佇まず
伜	倅
俯いた	俯いた
俯いて	俯いて
傅いた	傅いた
傅いて	傅いて
僣	僭
儚もう	儚まう
冀い	冀ひ
冀う	冀ふ
冀え	冀へ
冀おう	冀はう
冀わ	冀は
呟いた	呟いた
呟いて	呟いて
呻いた	呻いた
呻いて	呻いて
咬まず	咬まず
咬もう	咬まう
哄い	哄ひ
哄う	哄ふ
哄え	哄へ
哄おう	哄はう
哄わ	哄は
哭い	哭い
啣え	啣へ
啼いた	啼いた
啼いて	啼いて
喩い	喩ひ
喩いくつ	喩いくつ
喩いたしま	喩いたしま
喩いたす	喩いたす
喩いっ	喩いつ
喩え	喩へ
嗅い	嗅い
嗅ごう	嗅がう
嗜まず	嗜まず
嗜もう	嗜まう
嗤い	嗤ひ
嗤う	嗤ふ
嗤え	嗤へ
嗤おう	嗤はう
嗤わ	嗤は
嘶い	嘶い
噤まず	噤まず
嘯いた	嘯いた
嘯いて	嘯いて
囁いた	囁いた
囁いて	囁いて
夾まず	夾まず
夾もう	夾まう
奸知	奸智
孕まず	孕まず
孕もう	孕まう
已まず	已まず
彷徨い	彷徨ひ
彷徨いたした	彷徨いたした
彷徨いたして	彷徨いたして
彷徨いたしま	彷徨いたしま
彷徨いたす	彷徨いたす
彷徨いたせ	彷徨いたせ
彷徨いたそう	彷徨いたさう
彷徨う	彷徨ふ
彷徨え	彷徨へ
彷徨おう	彷徨はう
彷徨わ	彷徨は
恃まず	恃まず
愧じ	愧ぢ
憑いた	憑いた
憑いて	憑いて
懴	懺
拉いた	拉いた
拉いて	拉いて
拱いた	拱いた
拱いて	拱いて
拵え	拵へ
揉まず	揉まず
揉もう	揉まう
撓い	撓ひ
撓う	撓ふ
撓え	撓へ
撓おう	撓はう
撓まず	撓まず
撓わ	撓は
抬	擡
擲とう	擲たう
攫い	攫ひ
攫う	攫ふ
攫え	攫へ
攫おう	攫はう
攫わ	攫は
昿	曠
曰い	曰ひ
曰う	曰ふ
曰え	曰へ
曰おう	曰はう
曰わ	曰は
曵いた	曵いた
曵いて	曵いて
梳いた	梳いた
梳いて	梳いて
檪	櫟
殱	殲
浚い	浚ひ
浚う	浚ふ
浚え	浚へ
浚おう	浚はう
浚わ	浚は
渫い	渫ひ
渫う	渫ふ
渫え	渫へ
渫おう	渫はう
渫わ	渫は
灌ごう	灌がう
煌めいた	煌めいた
煌めいて	煌めいて
犇めいた	犇めいた
犇めいて	犇めいて
狢	貉
狡知	狡智
獏	貘
珱	瓔
畴	疇
疼いた	疼いた
疼いて	疼いて
眩いた	眩いた
眩いて	眩いて
眩まず	眩まず
眩もう	眩まう
睨まず	睨まず
睨もう	睨まう
祓らい	祓らひ
祓らう	祓らふ
祓らえ	祓らへ
祓らおう	祓らはう
祓らわ	祓らは
穢らわし	穢らはし
竦まず	竦まず
竦もう	竦まう
箋注	箋註
筝	箏
篩い	篩ひ
篩う	篩ふ
篩え	篩へ
篩おう	篩はう
篩わ	篩は
籠まず	籠まず
籖	籤
絨毯をしいて	絨毯をしいて
綯い	綯ひ
綯う	綯ふ
綯え	綯へ
綯おう	綯はう
綯わ	綯は
繙いた	繙いた
繙いて	繙いて
緕	纃
羞じ	羞ぢ
羞じらい	羞ぢらひ
羞じらう	羞ぢらふ
羞じらえ	羞ぢらへ
羞じらおう	羞ぢらはう
羞じらわ	羞ぢらは
羮	羹
腟	膣
苺	莓
虱	蝨
蠢いた	蠢いた
蠢いて	蠢いて
衒い	衒ひ
衒う	衒ふ
衒え	衒へ
衒おう	衒はう
衒わ	衒は
訥弁	訥辯
詛い	詛ひ
詛う	詛ふ
詛え	詛へ
詛おう	詛はう
詛わ	詛は
詭弁	詭辯
誂え	誂へ
諍い	諍ひ
諍う	諍ふ
諂い	諂ひ
諂う	諂ふ
諂え	諂へ
諂おう	諂はう
諂わ	諂は
謳い	謳ひ
謳う	謳ふ
謳え	謳へ
謳おう	謳はう
謳わ	謳は
譛	譖
譬い	譬ひ
譬え	譬へ
贖い	贖ひ
贖う	贖ふ
贖え	贖へ
贖おう	贖はう
贖わ	贖は
跪いた	跪いた
跪いて	跪いて
蹌踉めいた	蹌踉めいた
蹌踉めいて	蹌踉めいて
蹲い	蹲ひ
蹲う	蹲ふ
蹲え	蹲へ
蹲おう	蹲はう
蹲わ	蹲は
躊躇い	躊躇ひ
躊躇いたさ	躊躇いたさ
躊躇いたし	躊躇いたし
躊躇いたす	躊躇いたす
躊躇いたせ	躊躇いたせ
躊躇いたそう	躊躇いたさう
躊躇う	躊躇ふ
躊躇え	躊躇へ
躊躇おう	躊躇はう
躊躇わ	躊躇は
躓いた	躓いた
躓いて	躓いて
軋まず	軋まず
逎	遒
鈬	鐸
銜え	銜へ
鋏まず	鋏まず
鈩	鑪
鑚	鑽
閊え	閊へ
頌え	頌へ
頷いた	頷いた
頷いて	頷いて
顰まず	顰まず
饐えた臭い	饐えた臭ひ
鵞	鵝
鷏	鷆
麸	麩
靡いた	靡いた
靡いて	靡いて
靡かう	靡かふ
1回	1囘
1個	1箇
1編	1篇
1編集	1編輯
2回	2囘
2個	2箇
2編	2篇
2編集	2編輯
3回	3囘
3個	3箇
3編	3篇
3編集	3編輯
4回	4囘
4個	4箇
4編	4篇
4編集	4編輯
5回	5囘
5個	5箇
5編	5篇
5編集	5編輯
6回	6囘
6個	6箇
6編	6篇
7回	7囘
7個	7箇
7編	7篇
8回	8囘
8個	8箇
8編	8篇
9回	9囘
9個	9箇
9編	9篇
〇回	0囘
〇回	０囘
〇個	0箇
〇個	０箇
〇編	0篇
〇編	０篇
１回	１囘
１個	１箇
１編	１篇
１編集	１編輯
２回	２囘
２個	２箇
２編	２篇
２編集	２編輯
３回	３囘
３個	３箇
３編	３篇
３編集	３編輯
４回	４囘
４個	４箇
４編	４篇
４編集	４編輯
５回	５囘
５個	５箇
５編	５篇
５編集	５編輯
６回	６囘
６個	６箇
６編	６篇
７回	７囘
７個	７箇
７編	７篇
８回	８囘
８個	８箇
８編	８篇
９回	９囘
９個	９箇
９編	９篇
ああいう	ああいふ
あいかわら	あひかはら
あいきょう	あいきやう
あいすみま	あひすみま
あいた	あいた
あいたい	あひたい
あいたずさえ	あひたづさへ
あいだにはい	あひだにはい
あいまって	あひまつて
あがいた	あがいた
あがいて	あがいて
あさいねむり	あさいねむり
あさそう	あささう
あついぞ	あついぞ
あてはずれ	あてはづれ
あまえ	あまえ
ありついた	ありついた
ありついて	ありついて
あるいた	あるいた
あるいて	あるいて
いいあやま	いひあやま
いいあらそ	いひあらそ
いいかえ、	いひかへ、
いいかえが	いひかへが
いいかえさ	いひかへさ
いいかえざ	いひかへざ
いいかえし	いひかへし
いいかえす	いひかへす
いいかえず	いひかへず
いいかえせ	いひかへせ
いいかえそう	いひかへさう
いいかえた	いひかへた
いいかえて	いひかへて
いいかえぬ	いひかへぬ
いいかえの	いひかへの
いいかえは	いひかへは
いいかえま	いひかへま
いいかえも	いひかへも
いいかえよ	いひかへよ
いいかえる	いひかへる
いいかえれ	いひかえれ
いいかえを	いひかえを
いいかけ	いひかけ
いいかた	いひかた
いいかたにめぐ	いいかたにめぐ
いいかたに出	いいかたに出
いいかたに巡	いいかたに巡
いいかわさ	いひかはさ
いいかわす	いひかはす
いいかわせ	いひかはせ
いいかわそう	いひかはさう
いいがかり	いひがかり
いいくるめ	いひくるめ
いいぐさ	いひぐさ
いいこと	いいこと
いいささず	いひささず
いいささな	いひささな
いいさして	いひさして
いいさす	いひさす
いいさせば	いひさせば
いいしぶっ	いひしぶつ
いいしぶり	いひしぶり
いいしぶる	いひしぶる
いいすぎだ	いひすぎだ
いいすぎで	いひすぎで
いいすぎと	いひすぎと
いいすぎに	いひすぎに
いいすて	いひすて
いいそこな	いひそこな
いいそびれ	いひそびれ
いいたい	いひたい
いいたかっ	いひたかつ
いいたかにで	いいかたにで
いいたかろ	いひたかろ
いいたく	いひたく
いいたけれ	いひたけれ
いいたて	いひたて
いいだこ	いひだこ
いいだろう	いいだらう
いいちがい	いひちがひ
いいちがう	いひちがふ
いいちがえ	いひちがへ
いいちがおう	いひちがはう
いいちがっ	いひちがつ
いいちがわ	いひちがは
いいつく	いひつく
いいつけ	いひつけ
いいつつ	いひつつ
いいつづ	いひつづ
いいつの	いひつの
いいでしょう	いいでせう
いいです	いいです
いいなお	いひなほ
いいながら	いひながら
いいなずけ	いいなづけ
いいならわし	いひならはし
いいならわす	いひならはす
いいなり	いひなり
いいなりを	いいなりを
いいね	いいね
いいのがれ	いひのがれ
いいふくめ	いひふくめ
いいふら	いひふら
いいました	いひました
いいまして	いひまして
いいましょう	いひませう
いいます	いひます
いいません	いひません
いいまちがい	いひまちがひ
いいまちがう	いひまちがふ
いいまちがえ	いひまちがへ
いいまちがおう	いひまちがはう
いいまちがっ	いひまちがつ
いいまちがわ	いひまちがは
いいまわし	いひまはし
いいもの	いいもの
いいもらさ	いひもらさ
いいもらし	いひもらし
いいもらす	いひもらす
いいもらせば	いひもらせば
いいよ	いいよ
いいよどみ	いひよどみ
いいよどんだ	いひよどんだ
いいよどんで	いひよどんで
いいわけし	いひわけし
いいわけす	いひわけす
いいわけせ	いひわけせ
いいわたさ	いひわたさ
いいわたした	いひわたした
いいわたして	いひわたして
いいわたしま	いひわたしま
いいわたす	いひわたす
いいわたせ	いひわたせ
いいわたそ	いひわたそ
いいんだ	いいんだ
いいんで	いいんで
いうところ	いふところ
いうなら	いふなら
いうなれば	いふなれば
いうまで	いふまで
いかついぞ	いかついぞ
いきまいた	いきまいた
いきまいて	いきまいて
いじゃい	いじやひ
いじゃう	いじやふ
いじゃえ	いじやへ
いじゃおう	いじやはう
いじゃわ	いじやは
いじやっ	いじやつ
いっさい	いつさい
いっぱい	いつぱい
いまさら	いまさら
いまなお	いまなほ
いまもなお	いまもなほ
ういきょう	ういきやう
うとおり	うとほり
うまいったら	うまいつたら
うるさそう	うるささう
うわまわ	うはまは
おさないで	おさないで
おさないよう	おさないやう
おんみょう	おんみやう
お使い	お使ひ
お祝い	お祝ひ
お買い	お買ひ
お払い	お拂ひ
かんちょー	くわんちやう
がいう	がいふ
がおおい	がおほい
がくらい	がくらい
がめついぞ	がめついぞ
ききょう	ききやう
きずついた	きづついた
きずついち	きづついち
きずついて	きづついて
きずついと	きづついと
きついぞ	きついぞ
ぎついぞ	ぎついぞ
くさそう	くささう
くとおり	くとほり
ぐさそう	ぐささう
ぐとおり	ぐとほり
けっこう	けつこう
こういう	かういふ
ことさら	ことさら
ごっついぞ	ごっついぞ
ごついぞ	ごついぞ
しよう、	しよう、
しよう。	しよう。
しよう！	しよう！
しようが	しようが
しようがあり	しやうがあり
しようがない	しやうがない
しようがなかっ	しやうがなかつ
しようがなかろ	しやうがなかろ
しようがなく	しやうがなく
しようがなけれ	しやうがなけれ
しようがのう	しやうがのう
しようでは	しようでは
しようと	しようと
じょうぶ	ぢやうぶ
すこしいたい	すこしいたい
すごくいた	すごくいた
すっごくいた	すつごくいた
すとおり	すとほり
そういう	さういふ
たちが	たちが
たちがいた	たちがゐた
たちがいて	たちがゐて
たちがゐた	たちがゐた
たちがゐて	たちがゐて
たちがゐなくて	たちがゐなくて
たとおり	たとほり
だれかいて	だれかゐて
ちょっぴりいた	ちょっぴりいた
つとおり	つとほり
ていう	ていふ
でいう	でいふ
でいながら	でゐながら
できずだ	できずだ
できずで	できずで
できずの	できずの
という	といふ
ということ	といふこと
というもの	といふもの
とかいう	とかいふ
とってもいた	とってもいた
とてもいた	とてもいた
とでもいう	とでもいふ
とまがう	とまがふ
どういう	どういふ
どうのこうのいう	どうのかうのいふ
にいう	にいふ
にくらい	にくらい
にまがう	にまがふ
にもまがう	にもまがふ
ぬとおり	ぬとほり
のいう	のいふ
のおおい	のおほい
はいう	はいふ
はくらい	はくらい
はなお	はなほ
はなおが	はなをが
はなおを	はなをを
ふとおり	ふとほり
ぶとおり	ぶとほり
ほぼもう	ほぼもう
みまがう	みまがふ
むとおり	むとほり
もいう	もいふ
もうまく	もうまく
もくらい	もくらい
もなお	もなほ
やっぱりいた	やつぱりいた
よう。	よう。
ようがあ	やうがあ
ようがな	やうがな
ようじゃないか	ようぢやないか
ようではありませんか	ようではありませんか
ようではないか	ようではないか
ようではないですか	ようではないですか
ようとし	ようとし
ようとする	ようとする
ようにも	ようにも
ようはあ	やうはあ
ようはな	やうはな
ようもあ	やうもあ
ようもな	やうもな
よくいう	よくいふ
るとおり	るとほり
わたくし	わたくし
わたし	わたし
われら	われら
われわれ	われわれ
をいう	をいふ
イエイ	イエイ
ウエイ	ウエイ
カカリチョー	カカリチヤウ
カチョー	カチヤウ
カンチョーし	クワンチヤウし
カンチョーす	クワンチヤウす
キョクチョー	キョクチヤウ
シャチョー	シャチヤウ
ピストル1丁	ピストル1挺
ピストル2丁	ピストル2挺
ピストル3丁	ピストル3挺
ピストル4丁	ピストル4挺
ピストル5丁	ピストル5挺
ピストル6丁	ピストル6挺
ピストル7丁	ピストル7挺
ピストル8丁	ピストル8挺
ピストル9丁	ピストル9挺
ピストル１丁	ピストル１挺
ピストル２丁	ピストル２挺
ピストル３丁	ピストル３挺
ピストル４丁	ピストル４挺
ピストル５丁	ピストル５挺
ピストル６丁	ピストル６挺
ピストル７丁	ピストル７挺
ピストル８丁	ピストル８挺
ピストル９丁	ピストル９挺
ブチョー	ブチヤウ
委付	委付
移付	移付
一回	一囘
一憂	一憂
隠匿	隱匿
嘘発見機	嘘發見噐
営繕	榮繕
往訪	往訪
応諾	應諾
下付	下付
下付き	下附き
何回	何囘
加担	加擔
家族生活	家族生活
荷担	荷擔
快諾	快諾
外憂	外憂
勧誘	勧誘
還付	還付
期にはいって	期にはひつて
期にはいると	期にはひると
期にはいるなり	期にはひるなり
期にはいるや	期にはひるや
機嫌	機嫌
機構	機構
紀にはいって	紀にはひつて
紀にはいると	紀にはひると
紀にはいるなり	紀にはひるなり
紀にはいるや	紀にはひるや
記憶	記憶
休養	休養
急追	急追
給付	給付
許諾	許諾
供養	供養
九回	九囘
駆逐	駆逐
激しくいた	激しくいた
結構	結構
見まがう	見まがふ
五回	五囘
交付	交付
今なお	今なほ
昏迷	昏迷
混迷	混迷
栽培	栽培
裁縫	裁縫
錯迷	錯迷
三回	三囘
四回	四囘
治虫	治虫
七回	七囘
首肯	首肯
受諾	受諾
呪詛	呪詛
授付	授付
収賄	収賄
修繕	修繕
修養	修養
十回	十囘
銃1丁	銃1挺
銃2丁	銃2挺
銃3丁	銃3挺
銃4丁	銃4挺
銃5丁	銃5挺
銃6丁	銃6挺
銃7丁	銃7挺
銃8丁	銃8挺
銃9丁	銃9挺
銃１丁	銃１挺
銃２丁	銃２挺
銃３丁	銃３挺
銃４丁	銃４挺
銃５丁	銃５挺
銃６丁	銃６挺
銃７丁	銃７挺
銃８丁	銃８挺
銃９丁	銃９挺
銃が1丁	銃が1挺
銃が2丁	銃が2挺
銃が3丁	銃が3挺
銃が4丁	銃が4挺
銃が5丁	銃が5挺
銃が6丁	銃が6挺
銃が7丁	銃が7挺
銃が8丁	銃が8挺
銃が9丁	銃が9挺
銃が１丁	銃が１挺
銃が２丁	銃が２挺
銃が３丁	銃が３挺
銃が４丁	銃が４挺
銃が５丁	銃が５挺
銃が６丁	銃が６挺
銃が７丁	銃が７挺
銃が８丁	銃が８挺
銃が９丁	銃が９挺
銃は1丁	銃は1挺
銃は2丁	銃は2挺
銃は3丁	銃は3挺
銃は4丁	銃は4挺
銃は5丁	銃は5挺
銃は6丁	銃は6挺
銃は7丁	銃は7挺
銃は8丁	銃は8挺
銃は9丁	銃は9挺
銃は１丁	銃は１挺
銃は２丁	銃は２挺
銃は３丁	銃は３挺
銃は４丁	銃は４挺
銃は５丁	銃は５挺
銃は６丁	銃は６挺
銃は７丁	銃は７挺
銃は８丁	銃は８挺
銃は９丁	銃は９挺
銃を1丁	銃を1挺
銃を2丁	銃を2挺
銃を3丁	銃を3挺
銃を4丁	銃を4挺
銃を5丁	銃を5挺
銃を6丁	銃を6挺
銃を7丁	銃を7挺
銃を8丁	銃を8挺
銃を9丁	銃を9挺
銃を１丁	銃を１挺
銃を２丁	銃を２挺
銃を３丁	銃を３挺
銃を４丁	銃を４挺
銃を５丁	銃を５挺
銃を６丁	銃を６挺
銃を７丁	銃を７挺
銃を８丁	銃を８挺
銃を９丁	銃を９挺
傷ついた	傷ついた
傷ついち	傷ついち
傷ついて	傷ついて
傷ついと	傷ついと
少しいたい	少しいたい
少しだけいた	少しだけいた
承諾	承諾
常連	常連
深憂	深憂
人生	人生
随一	随一
随伴	随伴
数回	数囘
精養	精養
先遣	先遣
千回	千囘
宣誓	宣誓
洗濯	洗濯
訴追	訴追
阻喪	沮喪
相伴	相伴
装丁	裝幀
送付	送付
贈賄	贈賄
代にはいって	代にはひつて
代にはいると	代にはひると
代にはいるなり	代にはひるなり
代にはいるや	代にはひるや
誰かいた	誰かゐた
誰かいて	誰かゐて
探訪	探訪
聴きまがう	聽きまがふ
低迷	低迷
提携	提携
転付	轉付
転覆	顛覆
同伴	同伴
内諾	内諾
内紛	内紛
内憂	内憂
二回	二囘
納付	納付
派遣	派遣
配付	配付
培養	培養
八回	八囘
反覆	反覆
秘匿	秘匿
被覆	被覆
非常にいた	非常にいた
微妙にいた	微妙にいた
匹敵	匹敵
必携	必携
百回	百囘
付与	付與
扶養	扶養
普通	普通
負担	負擔
払拭	拂拭
分担	分擔
聞きまがう	聞きまがふ
返付	返付
保養	保養
放逐	放逐
万回	萬囘
妙にいた	妙にいた
猛追	猛追
唯一	唯一
来訪	来訪
療養	療養
歴訪	歴訪
連携	連携
六回	六囘
彌縫	彌縫
杞憂	杞憂
沮喪	沮喪
のよう。	のやう。
 なお	 なほ
 ようは	 えうは
 注	 註
 注意	 注意
　なお	　なほ
　ようは	　えうは
　注	　註
　注意	　注意
(なお	(なほ
（なお	（なほ
（ようは	（えうは
(ようは	(えうは
(注	(註
(注意	(注意
（注	（註
（注意	（注意
、なお	、なほ
。なお	。なほ
、ようは	、えうは
。ようは	。えうは
[なお	[なほ
[ようは	[えうは
[注	[註
[注意	[注意
［なお	［なほ
［ようは	［やうは
［注	［註
［注意	［注意
〈なお	〈なほ
〈ようは	〈えうは
〈注	〈註
〈注意	〈注意
《なお	《なほ
《ようは	《えうは
《注	《註
《注意	《注意
「なお	「なほ
「ようは	「えうは
【なお	【なほ
【ようは	【えうは
【注	【註
【注意	【注意
〔なお	〔はほ
〔ようは	〔えうは
〔注	〔註
〔注意	〔注意
＜なお	＜なほ
<なお	<なほ
＜ようは	＜えうは
<ようは	<えうは
<注	<註
<注意	<注意
\rなお	\rなほ
\rようは	\rえうは
\r注	\r註
\r注意	\r注意
…なお	…なほ
…ようは	…えうは
※なお	※なほ
※ようは	※やうは
※注	※註
※注意	※注意
T字	丁字
―なお	―なほ
―ようは	―えうは